把握	a;;
对于	b;;
好像	c;;
不知道	d;;
的确	e;;
一定	f;;
大家	g;;
地上	h;;
没有	i;;
是否	j;;
上面	k;;
中间	l;;
小时	m;;
回来	n;;
为什么	o;;
这样	p;;
我们	q;;
得到	r;;
在于	s;;
个人	t;;
着急	u;;
了解	v;;
然后	w;;
出来	x;;
心里	y;;
打开	aa;
取得	ab;
把握	ac;
顶级	ad;
抓住	ae;
捕捉	af;
找到	ag;
持续	ah;
接受	ai;
提高	aj;
下来	ak;
可以	al;
东西	am;
捉住	an;
按照	ao;
过去	ap;
才能	aq;
指出	ar;
措施	as;
抑制	at;
严重	au;
违反	av;
推动	aw;
报告	ax;
势力	ay;
对象	ba;
双方	bb;
丑陋	bc;
居住	bd;
改变	be;
登记	bf;
戏曲	bg;
屋里	bh;
已经	bi;
己见	bj;
观察	bk;
避免	bl;
母亲	bm;
展览会	bn;
尽量	bo;
屡次	bp;
属于	bq;
尾巴	br;
展示	bs;
通过	bt;
又是	bu;
局面	bv;
难道	bw;
劝说	bx;
鸡蛋	by;
导致	ca;
努力	cb;
她们	cc;
姑娘	cd;
附近	ce;
隔离	cf;
姨妈	cg;
妹妹	ch;
陪伴	ci;
阳光	cj;
妯娌	ck;
如果	cl;
姐姐	cm;
姻缘	cn;
防止	co;
嫉妒	cp;
姊妹	cq;
陛下	cr;
随时	cs;
除非	ct;
予以	cu;
女人	cv;
阴谋	cw;
妈妈	cx;
也是	cy;
趣味	da;
起来	db;
要求	dc;
歹徒	dd;
故事	de;
感到	df;
古代	dg;
基本	dh;
西方	di;
百姓	dj;
走到	dk;
否定	dl;
真正	dm;
丰富	dn;
尤其	do;
还是	dp;
其他	dq;
死亡	dr;
需要	ds;
零件	dt;
碰到	du;
成为	dv;
期间	dw;
甚至	dx;
确定	dy;
何况	ea;
反应	eb;
他们	ec;
什么	ed;
任何	ee;
条件	ef;
代表	eg;
倒是	eh;
位置	ei;
但是	ej;
伸出	ek;
各种	el;
处理	em;
促进	en;
仿佛	eo;
近代	ep;
作用	eq;
化学	er;
传统	es;
价格	et;
信息	eu;
仍然	ev;
遥远	ew;
似乎	ex;
你们	ey;
三个	fa;
权利	fb;
五十	fc;
无法	fd;
攻击	fe;
本身	ff;
天气	fg;
标准	fh;
一样	fi;
更加	fj;
两个	fk;
整个	fl;
相同	fm;
正确	fn;
工作	fo;
来到	fp;
机会	fq;
楷体	fr;
开始	fs;
检查	ft;
样子	fu;
根据	fv;
构成	fw;
功能	fx;
枕头	fy;
奇怪	ga;
巨大	gb;
靶子	gc;
环境	gd;
革命	ge;
玩笑	gf;
替代	gg;
鞋子	gh;
面前	gi;
春天	gj;
现在	gk;
或者	gl;
划分	gm;
大团圆	gn;
太阳	go;
达到	gp;
医生	gq;
大多数	gr;
弄清	gs;
珍惜	gt;
夫人	gu;
王朝	gv;
区别	gw;
擊打	gx;
牵连	gy;
寺院	ha;
声音	hb;
车子	hc;
城市	hd;
未来	he;
辅助	hf;
干活	hg;
款式	hh;
世界	hi;
都是	hj;
至于	hk;
喜欢	hl;
到了	hm;
到此为止	hn;
较为	ho;
连续	hp;
轶事	hq;
表现	hr;
转化	hs;
输出	ht;
增加	hu;
却是	hv;
均匀	hw;
匹配	hx;
轨迹	hy;
河流	ia;
汉语	ib;
池塘	ic;
漂亮	id;
所以	ie;
新闻	if;
汇报	ig;
法律	ih;
立即	ii;
意义	ij;
测量	ik;
部分	il;
消息	im;
遍布	in;
注意	io;
浏览	ip;
产生	iq;
活动	ir;
满足	is;
溜走	it;
淡淡	iu;
治疗	iv;
沟通	iw;
浸泡	ix;
学习	iy;
时候	ja;
照片	jb;
男女老少	jc;
岩石	jd;
暖和	je;
果然	jf;
畏惧	jg;
晴朗	jh;
暗示	ji;
晶莹	jj;
岗位	jk;
影响力	jl;
晃动	jm;
显然	jn;
影响	jo;
崆峒	jp;
昨天	jq;
岁月	jr;
山区	js;
田地	jt;
旷工	ju;
日子	jv;
明天	jw;
男女	jx;
思想	jy;
财产	ka;
贝壳	kb;
邮件	kc;
电子	kd;
申请	ke;
同时	kf;
贼人	kg;
水平	kh;
赔偿	ki;
螺旋	kj;
婴儿	kk;
蜗牛	kl;
叔叔	km;
螳螂	kn;
由于	ko;
遇到	kp;
贬义	kq;
蝌蚪	kr;
里面	ks;
内容	kt;
赚钱	ku;
虫子	kv;
刚才	kw;
见到	kx;
愚昧	ky;
叮嘱	la;
叹气	lb;
吧台	lc;
喊道	ld;
听到	le;
呆板	lf;
呈现	lg;
味道	lh;
非常	li;
喝酒	lj;
虽然	lk;
品种	ll;
吵架	lm;
#嘴里	ln;
咳嗽	lo;
斐然	lp;
吃饭	lq;
响起	lr;
号码	ls;
只有	lt;
兄弟姐妹	lu;
哪里	lv;
史学	lw;
#叫做	lx;
哈哈	ly;
小事	ma;
瞪大	mb;
小姑娘	mc;
置换	md;
睡觉	me;
幅度	mf;
虐待	mg;
光线	mh;
瞳孔	mi;
桌面	mj;
帽子	mk;
战争	ml;
帖子	mm;
虚伪	mn;
罚款	mo;
虔诚	mp;
少数	mq;
逻辑	mr;
瞒着	ms;
具体	mt;
目前	mu;
眼睛	mv;
瞧瞧	mw;
当然	mx;
睁开	my;
团结	na;
坚持	nb;
囡囡	nc;
固定	nd;
黑色	ne;
困难	nf;
因为	ng;
墨水	nh;
止步	ni;
旧式	nj;
赏识	nk;
回复	nl;
常常	nm;
趾甲	nn;
踪影	no;
過去	np;
四周	nq;
此外	nr;
尚且	ns;
掌握	nt;
业务	nu;
足以	nv;
肯定	nw;
躍居	nx;
跪下	ny;
讨论	oa;
记者	ob;
安排	oc;
家庭	od;
夜晚	oe;
语言	of;
方法	og;
诗歌	oh;
谚语	oi;
课程	oj;
永远	ok;
就是	ol;
市场	om;
颤抖	on;
房子	oo;
谜语	op;
许多	oq;
它们	or;
实现	os;
认为	ot;
说明	ou;
充分	ov;
调整	ow;
辛苦	ox;
密切	oy;
麻烦	pa;
变化	pb;
之后	pc;
糊涂	pd;
疼痛	pe;
空气	pf;
类型	pg;
精神	ph;
亦可	pi;
间接	pj;
袖子	pk;
问题	pl;
补充	pm;
门口	pn;
粮食	po;
迷惑	pp;
疾病	pq;
窗外	pr;
突然	ps;
容易	pt;
阅读	pu;
被动	pv;
文化	pw;
离开	px;
究竟	py;
年代	qa;
每个	qb;
川菜	qc;
顺利	qd;
符合	qe;
策略	qf;
重要	qg;
等等	qh;
篇章	qi;
几个	qj;
舰队	qk;
知道	ql;
怎么	qm;
凡是	qn;
管理	qo;
简单	qp;
气候	qq;
儿子	qr;
逃跑	qs;
签字	qt;
瓜果	qu;
第一	qv;
风格	qw;
笃信	qx;
答应	qy;
行为	ra;
径直	rb;
委托	rc;
德国	rd;
敌人	re;
微笑	rf;
狭窄	rg;
街道	rh;
匕首	ri;
香味	rj;
独立	rk;
程度	rl;
外面	rm;
向前	rn;
往往	ro;
适应	rp;
疑惑	rq;
多少	rr;
科学	rs;
徐州	rt;
秋天	ru;
很多	rv;
饱和	rw;
律师	rx;
称为	ry;
耐心	sa;
互相	sb;
薅羊毛	sc;
斗争	sd;
原则	se;
左右	sf;
头上	sg;
压力	sh;
范围	si;
莫非	sj;
英雄	sk;
冲突	sl;
布置	sm;
存在	sn;
丈夫	so;
蘑菇	sp;
董事	sq;
而且	sr;
某些	ss;
进行	st;
灰色	su;
运动	sv;
有的	sw;
历史	sx;
带来	sy;
昏迷	ta;
分析	tb;
人民币	tc;
针对	td;
人们	te;
途径	tf;
全部	tg;
长期	th;
镜头	ti;
留下	tj;
自己	tk;
钟头	tl;
看见	tm;
用于	tn;
今天	to;
片面	tp;
铁路	tq;
铭记	tr;
会议	ts;
从而	tt;
手段	tu;
创造	tv;
父亲	tw;
迎接	tx;
息怒	ty;
判断	ua;
羞愧	ub;
序列	uc;
烦恼	ud;
腐朽	ue;
差别	uf;
关系	ug;
社会	uh;
应该	ui;
单位	uj;
神经	uk;
总是	ul;
祖国	um;
普遍	un;
炫耀	uo;
熔点	up;
炸弹	uq;
将来	ur;
并且	us;
道德	ut;
广大	uu;
火车	uv;
前面	uw;
礼仪	ux;
忘记	uy;
那么	va;
经过	vb;
弛缓	vc;
迅速	vd;
终于	ve;
红色	vf;
参加	vg;
结果	vh;
编辑	vi;
细节	vj;
子女	vk;
强调	vl;
组织	vm;
引起	vn;
缩小	vo;
退出	vp;
乡村	vq;
绣花	vr;
飞机	vs;
费用	vt;
弹性	vu;
书籍	vv;
能够	vw;
纠正	vx;
绝对	vy;
射击	wa;
缺少	wb;
肥皂	wc;
卑鄙	wd;
身体	we;
集中	wf;
生活	wg;
特别	wh;
臆想	wi;
金子	wj;
制造	wk;
告诉	wl;
罅隙	wm;
牛奶	wn;
丹麦	wo;
脑袋	wp;
先生	wq;
脂肪	wr;
希望	ws;
忽然	wt;
焦虑	wu;
月亮	wv;
物体	ww;
服务	wx;
脆弱	wy;
建议	xa;
发生	xb;
驰骋	xc;
办不到	xd;
收到	xe;
卫生	xf;
骑车	xg;
以至于	xh;
骗人	xi;
翼展	xj;
录取	xk;
力量	xl;
马上	xm;
以此类推	xn;
以后	xo;
边缘	xp;
群体	xq;
出租车	xr;
收藏夹	xs;
办法	xt;
习惯	xu;
即使	xv;
驳斥	xw;
出现	xx;
加拿大	xy;
鸟类	ya;
快乐	yb;
色彩	yc;
怀疑	yd;
合作	ye;
杂志	yf;
惬意	yg;
情况	yh;
憧憬	yi;
慢慢	yj;
负责	yk;
象征	yl;
悄悄	ym;
心情	yn;
惊人	yo;
追求	yp;
必须	yq;
懊悔	yr;
食物	ys;
解决	yt;
忙碌	yu;
惨痛	yv;
性格	yw;
争斗	yx;
恰当	yy;
