一	一
丁	丁
七	七
万	一 勹
丈	{左上} 乀
三	三
上	上
下	下
丌	丌
不	不
与	丂 一
丐	丅 一 ㇉
丑	丑
专	二 ㇉ 丶
且	且
丕	不 一
世	世
丘	斤 一
丙	一 冂 人
业	业
丛	人 人 一
东	七 小
丝	{纟上} 纟
丞	乛 水 一
丢	壬 厶
两	一 冂 人 人
严	丌 䒑 丿
丧	十 丷 {畏下}
丨	丨
个	人 丨
丫	丷 丨
丬	丬
中	口 丨
丰	丰
串	口 口 丨
临	〢 {⺮右} 日
丶	丶
丸	九 丶
丹	⺆ 亠
为	丶 力 丶
主	丶 王
丽	一 {冂丶} {冂丶}
举	{兴上} 八 キ
丿	丿
乃	乃
久	冖 丶
乇	丿 七
么	丿 厶
义	丶 乂
之	之
乌	乌
乍	𠂉 {乍下}
乎	丿 丷 {于下}
乏	丿 之
乐	{乐上} 小
乒	斤 一 丿
乓	斤 一 丶
乔	夭 {介下}
乖	千 丬 匕
乘	禾 丬 匕
乙	乙
乜	乜
九	九
乞	𠂉 乙
也	也
习	习
乡	{纟上} 丿
书	乛 乛 丨 丶
乩	卜 口 乚
买	乛 ⺀ 大
乱	舌 乚
乳	爪 子 乚
乾	十 早 𠂉 乙
了	了
予	予
争	冖 彐 亅
事	{于下} 口 彐
二	二
亍	亍
于	一 {于下}
亏	一 丂
云	二 厶
互	一 彑
亓	一 丌
五	一 {五下}
井	二 {介下}
亘	一 日 一
亚	丌 䒑
些	止 匕 二
亟	了 口 又 一
亠	亠
亡	亡
亢	亠 几
交	亠 八 乂
亥	亥
亦	亦
产	立 丿
亨	{京頭} 了
亩	亠 田
享	{京頭} 子
京	{京頭} 小
亭	{亮頭} 丁
亮	{亮頭} 几
亲	立 木
亳	{亮頭} 丿 七
亵	亠 扌 九 𧘇
人	人
亻	亻
亿	亻 乙
什	亻 十
仁	亻 二
仂	亻 力
仃	亻 丁
仄	厂 人
仅	亻 又
仆	亻 卜
仇	亻 九
仉	亻 几
今	人 丶 乛
介	人 {介下}
仍	亻 乃
从	人 人
仑	人 匕
仓	人 㔾
仔	亻 子
仕	亻 士
他	亻 也
仗	亻 {左上} 乀
付	亻 寸
仙	亻 山
仝	人 工
仞	亻 刀 丶
仟	亻 千
仡	亻 𠂉 乙
代	亻 弋
令	人 丶 マ
以	乚 丶 人
仨	亻 三
仪	亻 丶 乂
仫	亻 丿 厶
们	亻 门
仰	亻 {卬左} 卩
仲	亻 口 丨
仳	亻 匕 匕
仵	亻 𠂉 十
件	亻 牛
价	亻 人 {介下}
任	亻 壬
份	亻 八 刀
仿	亻 方
企	人 止
伉	亻 亠 几
伊	亻 彐 丿
伍	亻 一 {五下}
伎	亻 十 又
伏	亻 犬
伐	亻 戈
休	亻 木
众	人 人 人
优	亻 尤
伙	亻 火
会	人 二 厶
伛	亻 匚 乂
伞	人 丷 十
伟	亻 キ 乛
传	亻 二 ㇉ 丶
伢	亻 牙
伤	亻 𠂉 力
伥	亻 长
伦	亻 人 匕
伧	亻 人 㔾
伪	亻 丶 力 丶
伫	亻 宀 一
伯	亻 白
估	亻 古
伲	亻 尸 匕
伴	亻 丷 キ
伶	亻 人 丶 マ
伸	亻 申
伺	亻 乛 一 口
似	亻 乚 丶 人
伽	亻 力 口
佃	亻 田
但	亻 日 一
位	亻 立
低	亻 {卬左} 七 丶
住	亻 丶 王
佐	亻 {左上} 工
佑	亻 {左上} 口
体	亻 木 一
何	亻 丁 口
佗	亻 宀 匕
佘	人 示
余	人 一 木
佚	亻 丿 夫
佛	亻 弓 {介下}
作	亻 𠂉 {乍下}
佝	亻 勹 口
佞	亻 二 女
佟	亻 夊 ⺀
你	亻 冖 小
佣	亻 用
佤	亻 瓦
佥	人 一 {兴上}
佧	亻 上 卜
佩	亻 几 一 巾
佬	亻 耂 匕
佯	亻 羊
佰	亻 丆 日
佳	亻 土 土
佴	亻 耳
佶	亻 士 口
佻	亻 儿 二 二
佼	亻 亠 八 乂
佾	亻 八 月
使	亻 一 口 乂
侃	亻 口 {荒下}
侄	亻 至
侈	亻 夕 夕
侉	亻 大 一 丂
例	亻 一 夕 刂
侍	亻 土 寸
侏	亻 牛 八
侑	亻 {左上} 月
侔	亻 厶 牛
侗	亻 冂 一 口
供	亻 龷 八
依	亻 亠 𧘇
侠	亻 夫 丷
侣	亻 口 口
侥	亻 七 丿 兀
侦	亻 卜 贝
侧	亻 贝 刂
侨	亻 夭 {介下}
侩	亻 人 二 厶
侪	亻 文 {介下}
侬	亻 冖 𧘇
侮	亻 𠂉 母
侯	亻 コ 矢
侵	亻 彐 冖 又
便	亻 一 日 乂
促	亻 足
俄	亻 丿 扌 戈
俅	亻 一 水 丶
俊	亻 厶 八 夊
俎	人 人 且
俏	亻 小 月
俐	亻 禾 刂
俑	亻 マ 用
俗	亻 八 人 口
俘	亻 爪 子
俚	亻 里
俜	亻 由 丂
保	亻 口 木
俞	人 一 月 刂
俟	亻 厶 矢
信	亻 言
俣	亻 口 一 大
俦	亻 丰 寸
俨	亻 丌 䒑 丿
俩	亻 一 冂 人
俪	亻 一 {冂丶} {冂丶}
俭	亻 人 一 {兴上}
修	亻 丨 夊 彡
俯	亻 广 亻 寸
俱	亻 且 八
俳	亻 非
俸	亻 𡗗 キ
俺	亻 大 电
俾	亻 {卑上} 十
倌	亻 宀 尸 コ
倍	亻 立 口
倏	亻 丨 夊 犬
倒	亻 至 刂
倔	亻 尸 屮 凵
倘	亻 尚
候	亻 丨 コ 矢
倚	亻 大 丁 口
倜	亻 ⺆ 土 口
借	亻 龷 日
倡	亻 日 日
倥	亻 穴 工
倦	亻 丷 夫 㔾
倨	亻 尸 古
倩	亻 龶 月
倪	亻 臼 儿
倬	亻 卜 早
倭	亻 禾 女
倮	亻 日 木
债	亻 龶 贝
值	亻 十 且
倾	亻 匕 丆 贝
偃	亻 匚 日 女
假	亻 尸 二 又
偈	亻 日 勹 乚
偌	亻 艹 {左上} 口
偎	亻 田 {畏下}
偏	亻 户 冊
偕	亻 匕 匕 白
做	亻 古 夊
停	亻 {亮頭} 丁
健	亻 彐 キ 廴
偬	亻 勹 {两撇} 心
偶	亻 禺
偷	亻 人 一 刂
偻	亻 米 女
偾	亻 十 卄 贝
偿	亻 龸 二 厶
傀	亻 鬼
傅	亻 甫 寸
傈	亻 西 木
傍	亻 亠 丷 方
傣	亻 𡗗 水
傥	亻 尚 儿
傧	亻 宀 斤 八
储	亻 讠 耂 日
傩	亻 又 隹
催	亻 山 隹
傲	亻 龶 勹 夊
傺	亻 {祭上} 示
傻	亻 {囟框} 乂 夊
像	亻 冖 口 豕
僖	亻 士 口 口
僚	亻 大 丷 小
僦	亻 {京頭} 小 尤
僧	亻 丷 日 日
僬	亻 隹 灬
僭	亻 匚 儿 日
僮	亻 立 里
僳	亻 西 米
僵	亻 一 田 一
僻	亻 尸 口 辛
儆	亻 艹 勹 夊
儇	亻 罒 一 𧘇
儋	亻 冖 厂 言
儒	亻 雨 而
儡	亻 田 田 田
儿	儿
兀	兀
允	厶 儿
元	一 兀
兄	口 儿
充	亠 厶 儿
兆	儿 二 二
先	⺧ 儿
光	小 兀
克	古 儿
免	冖 口 儿
兑	丷 口 儿
兔	冖 口 儿 丶
兕	{雋下} 兀
兖	亠 八 厶 儿
党	尚 儿
兜	白 {卬左} コ 儿
兢	古 儿 古 儿
入	入
全	人 王
八	八
公	八 厶
六	亠 八
兮	八 丂
兰	䒑 二
共	龷 八
关	䒑 大
兴	{兴上} 八
兵	斤 一 八
其	其
具	且 八
典	冂 龷 八
兹	䒑 幺 幺
养	䒑 夫 {介下}
兼	䒑 彐 〢 八
兽	丷 田 一 口
冀	丬 匕 田 八
冁	丷 日 十 {畏下}
冂	冂
内	冂 人
冈	冂 乂
冉	冂 土
册	⺆ ⺆ 一
再	王 冂
冒	冂 二 目
冕	冂 二 冖 儿
冖	冖
冗	冖 几
写	冖 丂 一
军	冖 车
农	冖 𧘇
冠	冖 一 兀 寸
冢	冖 豕 丶
冤	冖 冖 口 丶
冥	冖 日 亠 八
冫	二
冬	夊 ⺀
冯	二 马
冰	二 水
冱	二 一 彑
冲	二 口 丨
决	二 コ 人
况	二 口 儿
冶	二 厶 口
冷	二 人 丶 マ
冻	二 七 小
冼	二 ⺧ 儿
冽	二 一 夕 刂
净	二 冖 彐 亅
凄	二 十 彐 女
准	二 隹
凇	二 木 八 厶
凉	二 {京頭} 小
凋	二 ⺆ 土 口
凌	二 土 八 夊
减	二 戊 一 口
凑	二 𡗗 一 大
凛	二 亠 囗 示
凝	二 匕 矢 龰
几	几
凡	几 丶
凤	几 又
凫	{鸟上} 几
凭	亻 壬 几
凯	山 己 几
凰	几 白 王
凳	癶 一 口 几
凵	凵
凶	乂 凵
凸	丨 一 丨 一
凹	{雋下} 一
出	屮 凵
击	キ 凵
凼	水 凵
函	乛 水 凵
凿	业 䒑 十 凵
刀	刀
刁	乛 一
刂	刂
刃	刀 丶
分	八 刀
切	七 刀
刈	乂 刂
刊	干 刂
刍	冖 彐
刎	勹 {两撇} 刂
刑	一 卄 刂
划	戈 刂
刖	月 刂
列	一 夕 刂
刘	文 刂
则	贝 刂
刚	冂 乂 刂
创	人 㔾 刂
初	衤 刀
删	⺆ ⺆ 一 刂
判	丷 キ 刂
刨	勹 巳 刂
利	禾 刂
别	口 力 刂
刭	ス 工 刂
刮	舌 刂
到	至 刂
刳	大 一 丂 刂
制	牛 冂 刂
刷	尸 巾 刂
券	丷 夫 刀
刹	乂 木 刂
刺	木 冂 刂
刻	亥 刂
刽	人 二 厶 刂
刿	山 夕 刂
剀	山 己 刂
剁	几 木 刂
剂	文 {介下} 刂
剃	丷 弓 丨 刂
削	小 月 刂
剌	木 口 刂
前	䒑 月 刂
剐	口 冂 人 刂
剑	人 一 {兴上} 刂
剔	日 勹 {两撇} 刂
剖	立 口 刂
剜	宀 夕 㔾 刂
剞	大 丁 口 刂
剡	火 火 刂
剥	彐 水 刂
剧	尸 古 刂
剩	禾 丬 匕 刂
剪	䒑 月 刂 刀
副	一 口 田 刂
割	宀 丰 口 刂
剽	西 示 刂
剿	巛 日 木 刂
劁	隹 灬 刂
劂	厂 䒑 屮 刂
劈	尸 口 辛 刀
劐	艹 隹 又 刂
劓	自 田 丌 刂
力	力
劝	又 力
办	力 八
功	工 力
加	力 口
务	夊 力
劢	一 勹 力
劣	小 丿 力
动	二 厶 力
助	且 力
努	女 又 力
劫	土 厶 力
劬	勹 口 力
劭	刀 口 力
励	厂 一 勹 力
劲	ス 工 力
劳	艹 冖 力
劾	亥 力
势	扌 九 丶 力
勃	十 冖 子 力
勇	マ 用 力
勉	冖 口 儿 力
勋	口 贝 力
勐	子 皿 力
勒	革 力
勖	冂 二 目 力
勘	其 乚 力
募	艹 日 大 力
勤	革 二 力
勰	力 力 力 心
勹	勹
勺	勹 丶
勾	勹 厶
勿	勹 {两撇}
匀	勹 二
包	勹 巳
匆	勹 {两撇} 丶
匈	勹 乂 凵
匍	勹 甫
匏	大 一 丂 巳
匐	勹 一 口 田
匕	匕
化	亻 匕
北	丬 匕
匙	日 一 龰 匕
匚	匚
匝	匚 巾
匠	匚 斤
匡	匚 王
匣	匚 甲
匦	匚 车 九
匪	匚 非
匮	匚 口 丄 贝
匹	兀 乚
区	匚 乂
医	匚 矢
匾	匚 户 冊
匿	匚 艹 {左上} 口
十	十
千	千
卅	卅
升	丿 卄
午	𠂉 十
卉	十 卄
半	丷 キ
华	亻 匕 十
协	十 力 八
卑	{卑上} 十
卒	亠 人 人 十
卓	卜 早
单	丷 日 十
卖	十 乛 ⺀ 大
南	十 冂 䒑 十
博	十 甫 寸
卜	卜
卞	亠 卜
卟	口 卜
占	卜 口
卡	上 卜
卢	卜 尸
卣	卜 囗 コ
卤	卜 囗 乂
卦	土 土 卜
卧	臣 卜
卩	卩
卫	卩 一
卮	⺁ 一 㔾
卯	卯
印	{卬左} 一 卩
危	冖 厂 㔾
即	彐 厶 卩
却	土 厶 卩
卵	卯 丶 丶
卷	丷 夫 㔾
卸	𠂉 一 止 卩
卺	乛 水 一 㔾
卿	卯 彐 厶
厂	厂
厄	厂 㔾
厅	厂 丁
历	厂 力
厉	厂 一 勹
压	厂 土 丶
厌	厂 犬
厍	厂 车
厕	厂 贝 刂
厘	厂 里
厚	厂 日 子
厝	厂 龷 日
原	厂 白 小
厢	厂 木 目
厣	厂 犬 甲
厥	厂 䒑 屮 欠
厦	厂 丆 目 夊
厨	厂 一 口 寸
厩	厂 彐 厶 儿
厮	厂 其 斤
厶	厶
去	土 厶
县	且 厶
叁	厶 大 三
参	厶 大 彡
又	又
叉	又 丶
及	乃 乀
友	{左上} 又
双	又 又
反	⺁ 又
发	丩 又 丶
叔	上 小 又
取	耳 又
受	爪 冖 又
变	亦 又
叙	人 一 木 又
叛	丷 キ ⺁ 又
叟	臼 丨 又
叠	又 又 又 且
口	口
古	古
句	勹 口
另	口 力
叨	口 刀
叩	口 卩
只	口 八
叫	口 丩
召	刀 口
叭	口 八
叮	口 丁
可	丁 口
台	厶 口
叱	口 匕
史	口 乂
右	{左上} 口
叵	匚 口
叶	口 十
号	口 丂
司	乛 一 口
叹	口 又
叻	口 力
叼	口 乛 一
叽	口 几
吁	口 一 {于下}
吃	口 𠂉 乙
各	夊 口
吆	口 幺
合	合
吉	士 口
吊	口 巾
同	冂 一 口
名	夕 口
后	⺁ 一 口
吏	一 口 乂
吐	口 土
向	向
吒	口 丿 七
吓	口 下
吕	口 口
吖	口 丷 丨
吗	口 马
君	彐 丿 口
吝	文 口
吞	一 大 口
吟	口 人 丶 乛
吠	口 犬
吡	口 匕 匕
吣	口 心
否	不 口
吧	口 巴
吨	口 七 凵
吩	口 八 刀
含	人 丶 乛 口
听	口 斤
吭	口 亠 几
吮	口 厶 儿
启	户 口
吱	口 十 又
吲	口 弓 丨
吴	口 一 大
吵	口 小 丿
吸	口 乃 乀
吹	口 欠
吻	口 勹 {两撇}
吼	口 子 乚
吾	一 {五下} 口
呀	口 牙
呃	口 厂 㔾
呆	口 木
呈	口 王
告	⺧ 口
呋	口 夫
呐	口 冂 人
呒	口 一 尢
呓	口 艹 乙
呔	口 大 丶
呕	口 匚 乂
呖	口 厂 力
呗	口 贝
员	口 贝
呙	口 冂 人
呛	口 人 㔾
呜	口 乌
呢	口 尸 匕
呤	口 人 丶 マ
呦	口 幺 力
周	⺆ 土 口
呱	口 瓜
呲	口 止 匕
味	口 未
呵	口 丁 口
呶	口 女 又
呷	口 甲
呸	口 不 一
呻	口 申
呼	口 丿 丷 {于下}
命	合 卩
咀	口 且
咂	口 匚 巾
咄	口 屮 凵
咆	口 勹 巳
咋	口 𠂉 {乍下}
和	禾 口
咎	夊 卜 口
咏	口 丶 水
咐	口 亻 寸
咒	口 口 几
咔	口 上 卜
咕	口 古
咖	口 力 口
咙	口 尤 丿
咚	口 夊 ⺀
咛	口 宀 丁
咝	口 {纟上} 纟
咣	口 小 兀
咤	口 宀 丿 七
咦	口 大 弓
咧	口 一 夕 刂
咨	二 欠 口
咩	口 羊
咪	口 米
咫	尸 乀 口 八
咬	口 亠 八 乂
咭	口 士 口
咯	口 夊 口
咱	口 自
咳	口 亥
咴	口 {左上} 火
咸	戊 一 口
咻	口 亻 木
咽	口 囗 大
咿	口 亻 彐 丿
哀	{京頭} 𧘇
品	口 口 口
哂	口 西
哄	口 龷 八
哆	口 夕 夕
哇	口 土 土
哈	口 合
哉	十 戈 口
哌	口 ⺁ 𧘇
响	口 向
哎	口 艹 乂
哏	口 艮
哐	口 匚 王
哑	口 丌 䒑
哒	口 大 辶
哓	口 七 丿 兀
哔	口 匕 匕 十
哕	口 山 夕
哗	口 亻 匕 十
哙	口 人 二 厶
哚	口 几 木
哜	口 文 {介下}
哝	口 冖 𧘇
哞	口 厶 牛
哟	口 纟 勹 丶
哥	丁 口 丁 口
哦	口 丿 扌 戈
哧	口 土 {介下} 八
哨	口 小 月
哩	口 里
哪	口 乛 キ 阝
哭	口 口 犬
哮	口 耂 子
哲	扌 斤 口
哳	口 扌 斤
哺	口 甫
哼	口 {京頭} 了
哽	口 一 日 乂
哿	力 口 丁 口
唁	口 言
唆	口 厶 八 夊
唇	辰 口
唉	口 厶 矢
唏	口 乂 {左上} 巾
唐	广 肀 口
唑	口 人 人 土
唔	口 一 {五下} 口
唛	口 龶 夊
唠	口 艹 冖 力
唢	口 小 贝
唣	口 白 七
唤	口 冖 冂 大
唧	口 彐 厶 卩
唪	口 𡗗 キ
唬	口 虎
售	隹 口
唯	口 隹
唰	口 尸 巾 刂
唱	口 日 日
唳	口 户 犬
唷	口 亠 厶 月
唼	口 立 女
唾	口 壬 龷
唿	口 勹 {两撇} 心
啁	口 ⺆ 土 口
啃	口 止 月
啄	口 豕 丶
商	亠 丷 冂 口
啉	口 木 木
啊	口 阝 丁 口
啐	口 亠 人 十
啕	口 勹 缶
啖	口 火 火
啜	口 又 又 又
啡	口 非
啤	口 {卑上} 十
啥	口 人 干 口
啦	口 扌 立
啧	口 龶 贝
啪	口 扌 白
啬	十 䒑 囗 口
啭	口 车 二 丶
啮	口 止 人 凵
啵	口 氵 皮
啶	口 宀 一 龰
啷	口 丶 彐 阝
啸	口 肀 {介下} 八
啻	亠 丷 冖 口
啼	口 亠 丷 巾
啾	口 禾 火
喀	口 宀 夊 口
喁	口 禺
喂	口 田 {畏下}
喃	口 十 冂 十
善	羊 䒑 口
喇	口 木 口 刂
喈	口 匕 匕 白
喉	口 亻 コ 矢
喊	口 戊 一 口
喋	口 世 木
喏	口 艹 {左上} 口
喑	口 立 日
喔	口 尸 至
喘	口 山 而
喙	口 {互中} 豕
喜	士 口 䒑 口
喝	口 日 勹 乚
喟	口 田 月
喧	口 宀 一 一
喱	口 厂 里
喳	口 木 日 一
喵	口 艹 田
喷	口 十 卄 贝
喹	口 大 土 土
喻	口 人 一 刂
喽	口 米 女
喾	⺍ 冖 ⺧ 口
嗄	口 丆 目 夊
嗅	口 自 犬
嗉	口 龶 糸
嗌	口 䒑 八 皿
嗍	口 䒑 屮 月
嗑	口 土 厶 皿
嗒	口 艹 合
嗓	口 又 又 木
嗔	口 十 且 八
嗖	口 臼 丨 又
嗜	口 耂 匕 日
嗝	口 一 口 丨
嗟	口 羊 工
嗡	口 八 厶 习
嗣	口 冊 乛 口
嗤	口 屮 一 虫
嗥	口 白 大 十
嗦	口 十 冖 糸
嗨	口 氵 𠂉 母
嗪	口 𡗗 禾
嗫	口 耳 又 又
嗬	口 艹 亻 口
嗯	口 囗 大 心
嗲	口 八 乂 夕
嗳	口 爪 冖 又
嗵	口 マ 用 辶
嗷	口 龶 勹 夊
嗽	口 木 口 欠
嗾	口 方 𠂉 矢
嘀	口 亠 丷 古
嘁	口 戊 上 小
嘈	口 艹 日 日
嘉	士 口 䒑 口
嘌	口 西 示
嘎	口 丆 目 戈
嘏	古 尸 二 又
嘘	口 {虎头} 业
嘛	口 麻
嘞	口 革 力
嘟	口 耂 日 阝
嘣	口 山 月 月
嘤	口 贝 贝 女
嘧	口 宀 心 山
嘬	口 日 耳 又
嘭	口 士 口 彡
嘱	口 尸 丿 冂
嘲	口 十 早 月
嘴	口 止 匕 用
嘶	口 其 斤
嘹	口 大 丷 小
嘻	口 士 口 口
嘿	口 黑
噌	口 丷 日 日
噍	口 隹 灬
噎	口 士 冖 䒑
噔	口 癶 一 䒑
噗	口 业 䒑 夫
噘	口 厂 䒑 欠
噙	口 人 文 厶
噜	口 鱼 日
噢	口 {向框} 米 大
噤	口 木 木 示
器	口 口 犬 口
噩	王 口 口 口
噪	口 口 口 木
噫	口 立 日 心
噬	口 竹 工 人
噱	口 {虎头} 豕
噶	口 艹 日 乚
噻	口 宀 {冓上} 土
噼	口 尸 口 辛
嚅	口 雨 而
嚆	口 艹 高
嚎	口 {亮頭} 豕
嚏	口 十 冖 龰
嚓	口 宀 {祭上} 示
嚣	口 口 丆 口
嚯	口 雨 隹
嚷	口 {京頭} 口 𧘇
嚼	口 爪 罒 寸
囊	十 口 冖 𧘇
囔	口 十 口 𧘇
囗	囗
囚	囗 人
四	囗 儿
囝	囗 子
回	囗 口
囟	{囟框} 乂
因	囗 大
囡	囗 女
团	囗 {于下} 丿
囤	囗 七 凵
囫	囗 勹 {两撇}
园	囗 一 兀
困	囗 木
囱	{囟框} 夊
围	囗 キ 乛
囵	囗 人 匕
囹	囗 人 丶 マ
固	囗 古
国	囗 王 丶
图	囗 夊 ⺀
囿	囗 {左上} 月
圃	囗 甫
圄	囗 一 {五下} 口
圆	囗 口 贝
圈	囗 丷 夫 㔾
圉	囗 土 䒑 十
圊	囗 龶 月
圜	囗 罒 一 𧘇
土	土
圣	又 土
在	{左上} 丨 土
圩	土 一 {于下}
圪	土 𠂉 乙
圬	土 一 丂
圭	土 土
圮	土 己
圯	土 巳
地	土 也
圳	土 川
圹	土 广
场	土 𠄎 {两撇}
圻	土 斤
圾	土 乃 乀
址	土 止
坂	土 ⺁ 又
均	土 勹 二
坊	土 方
坌	八 刀 土
坍	土 ⺆ 亠
坎	土 欠
坏	土 不
坐	人 人 土
坑	土 亠 几
块	土 コ 人
坚	〢 又 土
坛	土 二 厶
坜	土 厂 力
坝	土 贝
坞	土 乌
坟	土 文
坠	阝 人 土
坡	土 皮
坤	土 申
坦	土 日 一
坨	土 宀 匕
坩	土 卄 二
坪	土 干 丷
坫	土 卜 口
坭	土 尸 匕
坯	土 不 一
坳	土 幺 力
坶	土 母
坷	土 丁 口
坻	土 {卬左} 七 丶
坼	土 斤 丶
垂	壬 龷
垃	土 立
垄	尤 丿 土
垅	土 尤 丿
垆	土 卜 尸
型	一 卄 刂 土
垌	土 冂 一 口
垒	厶 厶 厶 土
垓	土 亥
垛	土 几 木
垠	土 艮
垡	亻 戈 土
垢	土 ⺁ 一 口
垣	土 一 日 一
垤	土 至
垦	艮 土
垧	土 向
垩	丌 䒑 土
垫	扌 九 丶 土
垭	土 丌 䒑
垮	土 大 一 丂
垲	土 山 己
垴	土 文 凵
垸	土 宀 一 兀
埂	土 一 日 乂
埃	土 厶 矢
埋	土 里
城	土 戊 乛
埏	土 丿 止 廴
埒	土 爪 寸
埔	土 甫
埕	土 口 王
埘	土 日 寸
埙	土 口 贝
埚	土 口 冂 人
埝	土 人 丶 心
域	土 戈 口 一
埠	土 𠂤 十
埤	土 {卑上} 十
埭	土 彐 水
埯	土 大 电
埴	土 十 且
埸	土 日 勹 {两撇}
培	土 立 口
基	其 土
埽	土 彐 冖 巾
堀	土 尸 屮 凵
堂	尚 土
堆	土 隹
堇	革 二
堋	土 月 月
堍	土 冖 口 丶
堑	车 斤 土
堕	阝 {左上} 月 土
堙	土 西 土
堞	土 世 木
堠	土 亻 コ 矢
堡	亻 口 木 土
堤	土 日 一 龰
堪	土 其 乚
堰	土 匚 日 女
堵	土 耂 日
塄	土 罒 方
塌	土 日 习 习
塍	月 丷 夫 土
塑	䒑 屮 月 土
塔	土 艹 合
塘	土 广 肀 口
塞	宀 {冓上} 八 土
塥	土 一 口 丨
填	土 十 且 八
塬	土 厂 白 小
塾	{京頭} 子 九 土
墀	土 尸 水 牛
墁	土 日 罒 又
境	土 立 日 儿
墅	里 予 土
墉	土 广 肀 月
墒	土 亠 丷 口
墓	艹 日 大 土
墙	土 十 䒑 口
墚	土 氵 刀 木
增	土 丷 日 日
墟	土 {虎头} 业
墨	黑 土
墩	土 {京頭} 子 夊
墼	車 凵 殳 土
壁	尸 口 辛 土
壅	亠 {纟上} 丿 土
壑	卜 冖 一 土
壕	土 {亮頭} 豕
壤	土 {京頭} 口 𧘇
士	士
壬	壬
壮	丬 士
声	士 {眉上}
壳	士 冖 几
壶	士 冖 业
壹	士 冖 一 䒑
夂	夊
处	夊 卜
备	夊 田
复	𠂉 日 夊
夏	丆 目 夊
夔	䒑 自 止 夊
夕	夕
外	夕 卜
夙	几 一 夕
多	夕 夕
夜	亠 亻 夕 乀
够	勹 口 夕 夕
夤	夕 宀 一 八
夥	日 木 夕 夕
大	大
天	一 大
太	大 丶
夫	夫
夭	夭
央	冂 大
夯	大 力
失	丿 夫
头	⺀ 大
夷	大 弓
夸	大 一 丂
夹	夫 丷
夺	大 寸
夼	大 川
奁	大 匚 乂
奂	冖 冂 大
奄	大 电
奇	大 丁 口
奈	大 示
奉	𡗗 キ
奋	大 田
奎	大 土 土
奏	𡗗 一 大
契	丰 刀 大
奔	大 十 卄
奕	亦 大
奖	丬 夕 大
套	大 镸
奘	爿 士 大
奚	爪 幺 大
奠	丷 酉 大
奢	大 耂 日
奥	{向框} 米 大
女	女
奴	女 又
奶	女 乃
奸	女 干
她	女 也
好	女 子
妁	女 勹 丶
如	女 口
妃	女 己
妄	亡 女
妆	丬 女
妇	女 彐
妈	女 马
妊	女 壬
妍	女 一 卄
妒	女 户
妓	女 十 又
妖	女 夭
妗	女 人 丶 乛
妙	女 小 丿
妞	女 丑
妣	女 匕 匕
妤	女 予
妥	爪 女
妨	女 方
妩	女 一 尢
妪	女 匚 乂
妫	女 丶 力 丶
妮	女 尸 匕
妯	女 由
妲	女 日 一
妹	女 未
妻	十 彐 女
妾	立 女
姆	女 母
姊	女 丿 ㇉ 丿
始	女 厶 口
姐	女 且
姑	女 古
姒	女 乚 丶 人
姓	女 生
委	禾 女
姗	女 ⺆ ⺆ 一
姘	女 䒑 卄
姚	女 儿 二 二
姜	羊 女
姝	女 牛 八
姣	女 亠 八 乂
姥	女 耂 匕
姨	女 大 弓
姬	女 臣
姹	女 宀 丿 七
姻	女 囗 大
姿	二 欠 女
威	戊 一 女
娃	女 土 土
娄	米 女
娅	女 丌 䒑
娆	女 七 丿 兀
娇	女 夭 {介下}
娈	亦 女
娉	女 由 丂
娌	女 里
娑	氵 小 丿 女
娓	女 尸 毛
娘	女 丶 艮
娜	女 乛 キ 阝
娟	女 口 月
娠	女 辰
娣	女 丷 弓 丿
娥	女 丿 扌 戈
娩	女 冖 口 儿
娱	女 口 一 大
娲	女 口 冂 人
娴	女 门 木
娶	耳 又 女
娼	女 日 日
婀	女 阝 丁 口
婆	氵 皮 女
婉	女 宀 夕 㔾
婊	女 龶 𧘇
婕	女 一 彐 龰
婚	女 {卬左} 七 日
婢	女 {卑上} 十
婧	女 龶 月
婪	木 木 女
婴	贝 贝 女
婵	女 丷 日 十
婶	女 宀 申
婷	女 {亮頭} 丁
婺	予 丿 夊 女
婿	女 乛 龰 月
媒	女 卄 二 木
媚	女 {眉上} 目
媛	女 爪 干 又
媪	女 日 皿
媲	女 {囟框} 乂 匕
媳	女 自 心
媵	月 丷 夫 女
媸	女 屮 一 虫
媾	女 {冓上} 冂 土
嫁	女 宀 豕
嫂	女 臼 丨 又
嫉	女 疒 矢
嫌	女 䒑 彐 八
嫒	女 爪 冖 又
嫔	女 宀 斤 八
嫖	女 西 示
嫘	女 田 糸
嫜	女 立 早
嫠	未 夊 厂 女
嫡	女 亠 丷 古
嫣	女 一 止 灬
嫦	女 尚 巾
嫩	女 木 口 夊
嫫	女 艹 日 大
嫱	女 十 䒑 口
嬉	女 士 口 口
嬖	尸 口 辛 女
嬗	女 亠 囗 一
嬲	田 力 女 力
嬴	{贏頭} 女
嬷	女 麻 丿 厶
孀	女 雨 木 目
子	子
孑	了 一
孓	了 乀
孔	子 乚
孕	乃 子
字	宀 子
存	{左上} 丨 子
孙	子 小
孚	爪 子
孛	十 冖 子
孜	子 夊
孝	耂 子
孟	子 皿
孢	子 勹 巳
季	禾 子
孤	子 瓜
孥	女 又 子
学	⺍ 冖 子
孩	子 亥
孪	亦 子
孬	不 女 子
孰	{京頭} 子 九 丶
孱	尸 子 子 子
孳	䒑 幺 幺 子
孵	卯 丶 丶 子
孺	子 雨 而
孽	艹 𠂤 辛 子
宀	宀
宁	宀 丁
它	宀 匕
宄	宀 九
宅	宀 丿 七
宇	宀 一 {于下}
守	宀 寸
安	宀 女
宋	宀 木
完	宀 一 兀
宏	宀 {左上} 厶
宓	宀 心 丿
宕	宀 石
宗	宀 示
官	宀 尸 コ
宙	宀 由
定	宀 一 龰
宛	宀 夕 㔾
宜	宀 且
宝	宀 王 丶
实	宀 ⺀ 大
宠	宀 尤 丿
审	宀 申
客	宀 夊 口
宣	宀 一 日 一
室	宀 至
宥	宀 {左上} 月
宦	宀 臣
宪	宀 ⺧ 儿
宫	宀 口 口
宰	宀 辛
害	宀 丰 口
宴	宀 日 女
宵	宀 小 月
家	宀 豕
宸	宀 辰
容	穴 人 口
宽	宀 艹 见
宾	宀 斤 一 八
宿	宀 亻 丆 日
寂	宀 上 小 又
寄	宀 大 丁 口
寅	宀 一 由 八
密	宀 心 丿 山
寇	宀 一 兀 又
富	宀 一 口 田
寐	宀 爿 未
寒	宀 {冓上} 八 ⺀
寓	宀 禺
寝	宀 丬 彐 又
寞	宀 艹 日 大
察	宀 {祭上} 示
寡	宀 丆 且 刀
寤	宀 爿 一 口
寥	宀 习 习 彡
寨	宀 {冓上} 八 木
寮	宀 大 丷 小
寰	宀 罒 一 𧘇
寸	寸
对	又 寸
寺	土 寸
寻	彐 寸
导	巳 寸
寿	丰 寸
封	土 土 寸
射	身 寸
将	丬 夕 寸
尉	尸 示 寸
尊	丷 酉 寸
小	小
少	小 丿
尔	冖 小
尕	乃 小
尖	小 大
尘	小 土
尚	尚
尜	小 大 小
尝	龸 二 厶
尢	尢
尤	尤
尥	尢 勹 丶
尧	七 丿 兀
尬	尢 人 {介下}
就	{京頭} 小 尤
尴	尢 〢 {⺮右} 皿
尸	尸
尹	彐 丿
尺	尸 乀
尻	尸 九
尼	尸 匕
尽	尸 乀 ⺀
尾	尸 毛
尿	尸 水
局	尸 乛 口
屁	尸 匕 匕
层	尸 二 厶
居	尸 古
屈	尸 屮 凵
屉	尸 世
届	尸 由
屋	尸 至
屎	尸 米
屏	尸 䒑 卄
屐	尸 彳 十 又
屑	尸 小 月
展	尸 艹 {畏下}
屙	尸 阝 丁 口
属	尸 丿 虫 冂
屠	尸 耂 日
屡	尸 米 女
屣	尸 彳 止 龰
履	尸 彳 𠂉 夊
屦	尸 彳 米 女
屮	屮
屯	七 凵
山	山
屹	山 𠂉 乙
屺	山 己
屿	山 丂 一
岁	山 夕
岂	山 己
岈	山 牙
岌	山 乃 乀
岍	山 一 卄
岐	山 十 又
岑	山 人 丶 乛
岔	八 刀 山
岖	山 匚 乂
岗	山 冂 乂
岘	山 见
岙	夭 山
岚	山 几 乂
岛	{鸟上} 山
岜	山 巴
岢	山 丁 口
岣	山 勹 口
岩	山 石
岫	山 由
岬	山 甲
岭	山 人 丶 マ
岱	亻 弋 山
岳	斤 一 山
岵	山 古
岷	山 巳 七
岸	山 厂 干
岽	山 七 小
岿	山 リ 彐
峁	山 卯
峄	山 又 キ
峋	山 勹 日
峒	山 冂 一 口
峙	山 土 寸
峡	山 夫 丷
峤	山 夭 {介下}
峥	山 冖 彐 亅
峦	亦 山
峨	山 丿 扌 戈
峪	山 八 人 口
峭	山 小 月
峰	山 夊 丰
峻	山 厶 八 夊
崂	山 艹 冖 力
崃	山 一 米
崆	山 穴 工
崇	山 宀 示
崎	山 大 丁 口
崔	山 隹
崖	山 厂 土 土
崛	山 尸 屮 凵
崞	山 {京頭} 子
崤	山 乂 {左上} 月
崦	山 大 电
崧	山 木 八 厶
崩	山 月 月
崭	山 车 斤
崮	山 囗 古
崴	山 戊 一 女
崽	山 田 心
崾	山 西 女
嵇	禾 尤 山
嵊	山 禾 丬 匕
嵋	山 {眉上} 目
嵌	山 卄 二 欠
嵘	山 艹 冖 木
嵛	山 人 一 刂
嵝	山 米 女
嵩	山 高
嵫	山 䒑 幺 幺
嵬	山 鬼
嵯	山 羊 工
嵴	山 二 二 月
嶂	山 立 早
嶙	山 米 夕 ヰ
嶝	山 癶 一 䒑
嶷	山 匕 矢 龰
巅	山 十 且 贝
巍	山 禾 女 鬼
巛	巛
川	川
州	⺍ 川
巡	巛 辶
巢	巛 日 木
工	工
左	{左上} 工
巧	工 丂
巨	匚 コ
巩	工 几 丶
巫	工 人 人
差	羊 工
巯	ス 工 亠 {荒下}
己	己
已	已
巳	巳
巴	巴
巷	龷 八 巳
巽	巳 巳 龷 八
巾	巾
币	丿 巾
市	亠 巾
布	{左上} 巾
帅	リ 巾
帆	巾 几 丶
师	リ 一 巾
希	乂 {左上} 巾
帏	巾 キ 乛
帐	巾 长
帑	女 又 巾
帔	巾 皮
帕	巾 白
帖	巾 卜 口
帘	穴 巾
帙	巾 丿 夫
帚	彐 冖 巾
帛	白 巾
帜	巾 口 八
帝	亠 丷 冖 巾
带	卅 冖 巾
帧	巾 卜 贝
席	广 卄 一 巾
帮	丰 阝 巾
帱	巾 丰 寸
帷	巾 隹
常	尚 巾
帻	巾 龶 贝
帼	巾 囗 王 丶
帽	巾 冂 二 目
幂	冖 日 大 巾
幄	巾 尸 至
幅	巾 一 口 田
幌	巾 日 小 兀
幔	巾 日 罒 又
幕	艹 日 大 巾
幛	巾 立 早
幞	巾 业 䒑 夫
幡	巾 丿 米 田
幢	巾 立 里
干	干
平	干 丷
年	𠂉 ヰ
并	䒑 卄
幸	土 䒑 十
幺	幺
幻	幺 乛
幼	幺 力
幽	山 幺 幺
广	广
庀	广 匕
庄	广 土
庆	广 大
庇	广 匕 匕
床	广 木
庋	广 十 又
序	广 予
庐	广 户
庑	广 一 尢
库	广 车
应	广 {兴上}
底	广 {卬左} 七 丶
庖	广 勹 巳
店	广 卜 口
庙	广 由
庚	广 彐 人
府	广 亻 寸
庞	广 尤 丿
废	广 丩 又 丶
庠	广 羊
庥	广 亻 木
度	广 卄 一 又
座	广 人 人 土
庭	广 壬 廴
庳	广 {卑上} 十
庵	广 大 电
庶	广 卄 一 灬
康	广 彐 水
庸	广 肀 月
庹	广 卄 一 乀
庾	广 臼 人
廉	广 䒑 彐 八
廊	广 丶 彐 阝
廑	广 革 二
廒	广 龶 勹 夊
廓	广 {京頭} 子 阝
廖	广 习 习 彡
廛	广 里 八 土
廨	广 冖 用 牛
廪	广 亠 囗 示
廴	廴
延	丿 止 廴
廷	壬 廴
建	彐 キ 廴
廾	卄
廿	卄 一
开	一 卄
弁	厶 卄
异	巳 卄
弃	亠 厶 卄
弄	王 卄
弈	亦 卄
弊	丷 巾 八 卄
弋	弋
式	弋 工
弑	乂 木 弋 工
弓	弓
引	弓 丨
弗	弓 {介下}
弘	弓 厶
弛	弓 也
弟	丷 弓 丨 丿
张	弓 长
弥	弓 冖 小
弦	弓 亠 幺
弧	弓 瓜
弩	女 又 弓
弪	弓 ス 工
弭	弓 耳
弯	亦 弓
弱	弓 二 弓 二
弹	弓 丷 日 十
强	弓 口 虫
弼	弓 丆 日 弓
彀	{穀頭} 一 弓
彐	彐
归	リ 彐
当	小 彐
录	彐 水
彖	{互中} 豕
彗	丰 丰 彐
彘	彑 匕 矢 匕
彝	彑 米 糸 卄
彡	彡
形	一 卄 彡
彤	⺆ 亠 彡
彦	立 丿 彡
彩	爪 木 彡
彪	虎 彡
彬	木 木 彡
彭	士 口 䒑 彡
彰	立 早 彡
影	日 {京頭} 小 彡
彳	彳
彷	彳 方
役	彳 殳
彻	彳 七 刀
彼	彳 皮
往	彳 丶 王
征	彳 一 止
徂	彳 且
径	彳 ス 工
待	彳 土 寸
徇	彳 勹 日
很	彳 艮
徉	彳 羊
徊	彳 囗 口
律	彳 彐 キ
後	彳 幺 夊
徐	彳 人 一 木
徒	彳 走
徕	彳 一 米
得	彳 日 一 寸
徘	彳 非
徙	彳 止 龰
徜	彳 尚
御	彳 𠂉 一 卩
徨	彳 白 王
循	彳 ⺁ 十 目
徭	彳 爪 缶
微	{微上} 一 几
徵	{微上} 一 王
德	彳 十 罒 心
徼	彳 白 方 夊
徽	{微上} 一 糸
心	心
忄	忄
必	心 丿
忆	忄 乙
忉	忄 刀
忌	己 心
忍	刀 丶 心
忏	忄 千
忐	上 心
忑	下 心
忒	弋 心
忖	忄 寸
志	士 心
忘	亡 心
忙	忄 亡
忝	一 大 小 丶
忠	口 丨 心
忡	忄 口 丨
忤	忄 𠂉 十
忧	忄 尤
忪	忄 八 厶
快	忄 コ 人
忭	忄 亠 卜
忮	忄 十 又
忱	忄 冖 儿
念	人 丶 乛 心
忸	忄 丑
忻	忄 斤
忽	勹 {两撇} 心
忾	忄 气
忿	八 刀 心
怀	忄 不
态	大 丶 心
怂	人 人 心
怃	忄 一 尢
怄	忄 匚 乂
怅	忄 长
怆	忄 人 㔾
怊	忄 刀 口
怍	忄 𠂉 {乍下}
怎	𠂉 {乍下} 心
怏	忄 冂 大
怒	女 又 心
怔	忄 一 止
怕	忄 白
怖	忄 {左上} 巾
怙	忄 古
怛	忄 日 一
怜	忄 人 丶 マ
思	田 心
怠	厶 口 心
怡	忄 厶 口
急	冖 彐 心
怦	忄 干 丷
性	忄 生
怨	夕 㔾 心
怩	忄 尸 匕
怪	忄 又 土
怫	忄 弓 {介下}
怯	忄 土 厶
怵	忄 木 丶
总	丷 口 心
怼	又 寸 心
怿	忄 又 キ
恁	亻 壬 心
恂	忄 勹 日
恃	忄 土 寸
恋	亦 心
恍	忄 小 兀
恐	工 几 丶 心
恒	忄 一 日 一
恕	女 口 心
恙	羊 心
恚	土 土 心
恝	丰 刀 心
恢	忄 {左上} 火
恣	二 欠 心
恤	忄 丿 皿
恧	而 心
恨	忄 艮
恩	囗 大 心
恪	忄 夊 口
恫	忄 冂 一 口
恬	忄 舌
恭	龷 八 小 丶
息	自 心
恰	忄 合
恳	艮 心
恶	丌 䒑 心
恸	忄 二 厶 力
恹	忄 厂 犬
恺	忄 山 己
恻	忄 贝 刂
恼	忄 文 凵
恽	忄 冖 车
恿	マ 用 心
悃	忄 囗 木
悄	忄 小 月
悉	丿 米 心
悌	忄 丷 弓 丿
悍	忄 日 干
悒	忄 口 巴
悔	忄 𠂉 母
悖	忄 十 冖 子
悚	忄 木 口
悛	忄 厶 八 夊
悝	忄 里
悟	忄 一 {五下} 口
悠	亻 丨 夊 心
患	口 口 丨 心
悦	忄 丷 口 儿
您	亻 冖 小 心
悫	士 冖 几 心
悬	且 厶 心
悭	忄 〢 又 土
悯	忄 门 文
悱	忄 非
悲	非 心
悴	忄 亠 人 十
悸	忄 禾 子
悻	忄 土 䒑 十
悼	忄 卜 早
情	忄 龶 月
惆	忄 ⺆ 土 口
惊	忄 {京頭} 小
惋	忄 宀 夕 㔾
惑	戈 口 一 心
惕	忄 日 勹 {两撇}
惘	忄 冂 䒑 亡
惚	忄 勹 {两撇} 心
惜	忄 龷 日
惝	忄 尚
惟	忄 隹
惠	{專上} 心
惦	忄 广 卜 口
惧	忄 且 八
惨	忄 厶 大 彡
惩	彳 一 止 心
惫	夊 田 心
惬	忄 匚 夫 丷
惭	忄 车 斤
惮	忄 丷 日 十
惯	忄 {母框} 十 贝
惰	忄 {左上} 工 月
想	木 目 心
惴	忄 山 而
惶	忄 白 王
惹	艹 {左上} 口 心
惺	忄 日 生
愀	忄 禾 火
愁	禾 火 心
愆	彳 氵 亍 心
愈	人 一 月 心
愉	忄 人 一 刂
愍	巳 七 夊 心
愎	忄 𠂉 日 夊
意	立 日 心
愕	忄 口 口 丂
愚	禺 心
感	戊 一 口 心
愠	忄 日 皿
愣	忄 罒 方
愤	忄 十 卄 贝
愦	忄 口 丄 贝
愧	忄 鬼
愫	忄 龶 糸
愿	厂 白 小 心
慈	䒑 幺 幺 心
慊	忄 䒑 彐 八
慌	忄 艹 亡 {荒下}
慎	忄 十 且 八
慑	忄 耳 又 又
慕	艹 日 大 丶
慝	匚 艹 {左上} 心
慢	忄 日 罒 又
慧	丰 丰 彐 心
慨	忄 彐 厶 儿
慰	尸 示 寸 心
慵	忄 广 肀 月
慷	忄 广 彐 水
憋	丷 巾 八 心
憎	忄 丷 日 日
憔	忄 隹 灬
憝	{京頭} 子 夊 心
憧	忄 立 里
憨	乛 耳 夊 心
憩	舌 自 心
憬	忄 日 {京頭} 小
憷	忄 木 木 龰
憾	忄 戊 一 心
懂	忄 艹 千 里
懈	忄 冖 用 牛
懊	忄 {向框} 米 大
懋	木 予 丿 心
懑	氵 艹 一 心
懒	忄 木 口 贝
懔	忄 亠 囗 示
懦	忄 雨 而
懵	忄 艹 罒 目
懿	士 冖 一 心
戆	立 早 夊 心
戈	戈
戊	戊
戋	一 戈
戌	戊 一
戍	戊 丶
戎	戈 {左上}
戏	又 戈
成	戊 乛
我	丿 扌 戈
戒	戈 卄
戕	爿 戈
或	戈 口 一
戗	人 㔾 戈
战	卜 口 戈
戚	戊 上 小
戛	丆 目 戈
戟	十 早 戈
戡	其 乚 戈
戢	口 耳 戈
戤	乃 又 皿 戈
戥	日 生 戈
截	十 戈 隹
戬	丌 䒑 日 戈
戮	习 习 人 戈
戳	习 习 隹 戈
戴	十 戈 田 八
户	户
戽	户 ⺀ 十
戾	户 犬
房	户 方
所	戶 斤
扁	户 冊
扃	户 冂 口
扇	户 习 习
扈	户 口 巴
扉	户 非
手	手
扌	扌
才	{于下} 丿
扎	扌 乚
扑	扌 卜
扒	扌 八
打	扌 丁
扔	扌 乃
托	扌 丿 七
扛	扌 工
扣	扌 口
扦	扌 千
执	扌 九 丶
扩	扌 广
扪	扌 门
扫	扌 彐
扬	扌 𠄎 {两撇}
扭	扌 丑
扮	扌 八 刀
扯	扌 止
扰	扌 尤
扳	扌 ⺁ 又
扶	扌 夫
批	扌 匕 匕
扼	扌 厂 㔾
找	扌 戈
承	乛 水 三
技	扌 十 又
抄	扌 小 丿
抉	扌 コ 人
把	扌 巴
抑	扌 {卬左} 卩
抒	扌 予
抓	扌 爪
投	扌 殳
抖	扌 ⺀ 十
抗	扌 亠 几
折	扌 斤
抚	扌 一 尢
抛	扌 九 力
抟	扌 二 ㇉ 丶
抠	扌 匚 乂
抡	扌 人 匕
抢	扌 人 㔾
护	扌 户
报	扌 卩 又
抨	扌 干 丷
披	扌 皮
抬	扌 厶 口
抱	扌 勹 巳
抵	扌 {卬左} 七 丶
抹	扌 末
抻	扌 申
押	扌 甲
抽	扌 由
抿	扌 巳 七
拂	扌 弓 {介下}
拄	扌 丶 王
担	扌 日 一
拆	扌 斤 丶
拇	扌 母
拈	扌 卜 口
拉	扌 立
拊	扌 亻 寸
拌	扌 丷 キ
拍	扌 白
拎	扌 人 丶 マ
拐	扌 口 力
拒	扌 匚 コ
拓	扌 石
拔	扌 {左上} 又 丶
拖	扌 𠂉 也
拗	扌 幺 力
拘	扌 勹 口
拙	扌 屮 凵
拚	扌 厶 卄
招	扌 刀 口
拜	龵 一 丰
拟	扌 乚 丶 人
拢	扌 尤 丿
拣	扌 七 乛 八
拥	扌 用
拦	扌 䒑 二
拧	扌 宀 丁
拨	扌 丩 又 丶
择	扌 又 キ
括	扌 舌
拭	扌 弋 工
拮	扌 士 口
拯	扌 乛 水 一
拱	扌 龷 八
拳	丷 夫 手
拴	扌 人 王
拶	扌 巛 夕
拷	扌 耂 丂
拼	扌 䒑 卄
拽	扌 电 丿
拾	扌 合
拿	合 手
持	扌 土 寸
挂	扌 土 土
指	扌 匕 日
挈	丰 刀 手
按	扌 宀 女
挎	扌 大 一 丂
挑	扌 儿 二 二
挖	扌 穴 乙
挚	扌 九 丶 手
挛	亦 手
挝	扌 寸 辶
挞	扌 大 辶
挟	扌 夫 丷
挠	扌 七 丿 兀
挡	扌 小 彐
挢	扌 夭 {介下}
挣	扌 冖 彐 亅
挤	扌 文 {介下}
挥	扌 冖 车
挨	扌 厶 矢
挪	扌 乛 キ 阝
挫	扌 人 人 土
振	扌 辰
挲	氵 小 丿 手
挹	扌 口 巴
挺	扌 壬 廴
挽	扌 冖 口 儿
捂	扌 一 {五下} 口
捃	扌 彐 丿 口
捅	扌 マ 用
捆	扌 囗 木
捉	扌 足
捋	扌 爪 寸
捌	扌 口 力 刂
捍	扌 日 干
捎	扌 小 月
捏	扌 日 土
捐	扌 口 月
捕	扌 甫
捞	扌 艹 冖 力
损	扌 口 贝
捡	扌 人 一 {兴上}
换	扌 冖 冂 大
捣	扌 {鸟上} 山
捧	扌 𡗗 キ
捩	扌 户 犬
捭	扌 {卑上} 十
据	扌 尸 古
捱	扌 厂 土 土
捶	扌 壬 龷
捷	扌 一 彐 龰
捺	扌 大 示
捻	扌 人 丶 心
掀	扌 斤 欠
掂	扌 广 卜 口
掇	扌 又 又 又
授	扌 爪 冖 又
掉	扌 卜 早
掊	扌 立 口
掌	尚 手
掎	扌 大 丁 口
掏	扌 勹 缶
掐	扌 冖 臼
排	扌 非
掖	扌 亠 亻 乀
掘	扌 尸 屮 凵
掠	扌 {京頭} 小
探	扌 冖 八 木
掣	牛 冂 刂 手
接	扌 立 女
控	扌 穴 工
推	扌 隹
掩	扌 大 电
措	扌 龷 日
掬	扌 勹 米
掭	扌 一 大 丶
掮	扌 户 月
掰	龵 八 刀 手
掳	扌 {虎头} 力
掴	扌 囗 王 丶
掷	扌 䒑 大 阝
掸	扌 丷 日 十
掺	扌 厶 大 彡
掼	扌 {母框} 十 贝
掾	扌 {互中} 豕
揄	扌 人 一 刂
揆	扌 癶 一 大
揉	扌 予 丿 木
揍	扌 𡗗 一 大
揎	扌 宀 一 一
描	扌 艹 田
提	扌 日 一 龰
插	扌 千 臼
揖	扌 口 耳
揞	扌 立 日
揠	扌 匚 日 女
握	扌 尸 至
揣	扌 山 而
揩	扌 匕 匕 白
揪	扌 禾 火
揭	扌 日 勹 乚
揲	扌 世 木
援	扌 爪 干 又
揶	扌 耳 阝
揸	扌 木 日 一
揽	扌 〢 {⺮右} 见
揿	扌 钅 欠
搀	扌 冖 口 ⺀
搁	扌 门 夊 口
搂	扌 米 女
搅	扌 ⺍ 冖 见
搋	扌 ⺁ 虎
搌	扌 尸 艹 {畏下}
搏	扌 甫 寸
搐	扌 亠 幺 田
搓	扌 羊 工
搔	扌 又 丶 虫
搛	扌 䒑 彐 八
搜	扌 臼 丨 又
搞	扌 高
搠	扌 䒑 屮 月
搡	扌 又 又 木
搦	扌 弓 二 二
搪	扌 广 肀 口
搬	扌 舟 殳
搭	扌 艹 合
搴	宀 {冓上} 八 手
携	扌 隹 乃
搽	扌 艹 人 木
搿	龵 合 手
摁	扌 囗 大 心
摄	扌 耳 又 又
摅	扌 {虎头} 心
摆	扌 罒 土 厶
摇	扌 爪 缶
摈	扌 宀 斤 八
摊	扌 又 隹
摒	扌 尸 䒑 卄
摔	扌 亠 幺 十
摘	扌 亠 丷 古
摞	扌 田 糸
摧	扌 山 隹
摩	麻 手
摭	扌 广 卄 灬
摸	扌 艹 日 大
摹	艹 日 大 手
摺	扌 习 习 白
撂	扌 田 夊 口
撄	扌 贝 贝 女
撅	扌 厂 䒑 欠
撇	扌 丷 巾 夊
撑	扌 尚 手
撒	扌 龷 月 夊
撕	扌 其 斤
撖	扌 乛 耳 夊
撙	扌 丷 酉 寸
撞	扌 立 里
撤	扌 亠 厶 夊
撩	扌 大 丷 小
撬	扌 毛 毛 毛
播	扌 丿 米 田
撮	扌 日 耳 又
撰	扌 巳 巳 八
撵	扌 夫 夫 车
撷	扌 士 口 贝
撸	扌 鱼 日
撺	扌 穴 口 丨
撼	扌 戊 一 心
擀	扌 十 早 干
擂	扌 雨 田
擅	扌 亠 囗 一
操	扌 口 口 木
擎	艹 勹 口 手
擐	扌 罒 一 𧘇
擒	扌 人 文 厶
擗	扌 尸 口 辛
擘	尸 口 辛 手
擞	扌 米 女 夊
擢	扌 习 习 隹
擤	扌 自 田 丌
擦	扌 宀 {祭上} 示
攀	木 乂 乂 手
攉	扌 雨 隹
攒	扌 ⺧ 儿 贝
攘	扌 {京頭} 口 𧘇
攥	扌 竹 目 糸
攫	扌 目 目 又
攮	扌 十 口 𧘇
支	十 又
攴	卜 又
攵	夊
收	丩 夊
攸	亻 丨 夊
改	己 夊
攻	工 夊
放	方 夊
政	一 止 夊
故	古 夊
效	亠 八 乂 夊
敉	米 夊
敌	舌 夊
敏	𠂉 母 夊
救	一 水 丶 夊
敕	木 口 夊
敖	龶 勹 夊
教	耂 子 夊
敛	人 一 {兴上} 夊
敝	丷 巾 八 夊
敞	尚 夊
敢	乛 耳 夊
散	龷 月 夊
敦	{京頭} 子 夊
敫	白 方 夊
敬	艹 勹 口 夊
数	米 女 夊
敲	高 卜 又
整	木 口 夊 止
敷	甫 方 夊
文	文
斋	文 而
斌	文 一 弋 止
斐	非 文
斑	王 文 王
斓	文 门 木 丷
斗	⺀ 十
料	米 ⺀ 十
斛	冖 用 ⺀ 十
斜	人 一 木 十
斟	其 乚 ⺀ 十
斡	十 早 人 十
斤	斤
斥	斤 丶
斧	八 乂 斤
斩	车 斤
斫	石 斤
断	米 乚 斤
斯	其 斤
新	立 木 斤
方	方
於	方 人 ⺀
施	方 𠂉 也
旁	亠 丷 冖 方
旃	方 𠂉 ⺆ 亠
旄	方 𠂉 毛
旅	方 𠂉 𧘇
旆	方 𠂉 一 巾
旋	方 𠂉 乛 龰
旌	方 𠂉 生
旎	方 𠂉 尸 匕
族	方 𠂉 矢
旒	方 𠂉 亠 {荒下}
旖	方 𠂉 大 口
旗	方 𠂉 其
无	一 尢
既	彐 厶 匚 儿
日	日
旦	日 一
旧	丨 日
旨	匕 日
早	早
旬	勹 日
旭	九 日
旮	九 日
旯	日 九
旰	日 干
旱	日 干
时	日 寸
旷	日 广
旺	日 王
昀	日 勹 二
昂	日 {卬左} 卩
昃	日 厂 人
昆	日 匕 匕
昊	日 一 大
昌	日 日
明	日 月
昏	{卬左} 七 日
易	日 勹 {两撇}
昔	龷 日
昕	日 斤
昙	日 二 厶
昝	夊 卜 日
星	日 生
映	日 冂 大
春	𡗗 日
昧	日 未
昨	日 𠂉 {乍下}
昭	日 刀 口
是	日 一 龰
昱	日 立
昴	日 卯
昵	日 尸 匕
昶	丶 水 日
昼	尸 乀 日 一
显	日 业
晁	日 儿 二 二
晃	日 小 兀
晋	丌 䒑 日
晌	日 向
晏	日 宀 女
晒	日 西
晓	日 七 丿 兀
晔	日 亻 匕 十
晕	日 冖 车
晖	日 冖 车
晗	日 人 丶 口
晚	日 冖 口 儿
晟	日 戊 乛
晡	日 甫
晤	日 一 {五下} 口
晦	日 𠂉 母
晨	日 辰
普	䒑 业 日
景	日 {京頭} 小
晰	日 木 斤
晴	日 龶 月
晶	日 日 日
晷	日 夊 卜 口
智	矢 口 日
晾	日 {京頭} 小
暂	车 斤 日
暄	日 宀 一 一
暇	日 尸 二 又
暌	日 癶 一 大
暑	日 耂 日
暖	日 爪 干 又
暗	日 立 日
暝	日 冖 日 八
暧	日 爪 冖 又
暨	彐 厶 匚 一
暮	艹 日 大 日
暴	日 龷 八 水
暹	日 隹 辶
暾	日 {京頭} 子 夊
曙	日 罒 耂 日
曛	日 千 黑
曜	日 习 习 隹
曝	日 日 龷 水
曦	日 羊 禾 戈
曩	日 {京頭} 口 𧘇
曰	曰
曲	冂 龷
曳	电 丿
更	一 日 乂
曷	日 勹 人 乚
曹	艹 日 日
曼	日 罒 又
曾	丷 日 丷 日
替	夫 夫 日
最	日 耳 又
月	月
有	{左上} 月
朊	月 一 兀
朋	月 月
服	月 卩 又
朐	月 勹 口
朔	䒑 屮 月
朕	月 䒑 大
朗	丶 彐 厶 月
望	亡 月 王
朝	十 早 月
期	其 月
朦	月 艹 冖 豕
木	木
未	未
末	末
本	木 一
札	木 乚
术	木 丶
朱	牛 八
朴	木 卜
朵	几 木
机	木 几
朽	木 丂
杀	乂 木
杂	九 木
权	木 又
杆	木 干
杈	木 又 丶
杉	木 彡
杌	木 兀
李	木 子
杏	木 口
材	木 {于下} 丿
村	木 寸
杓	木 勹 丶
杖	木 {左上} 乀
杜	木 土
杞	木 己
束	木 口
杠	木 工
条	夊 木
来	一 米
杨	木 𠄎 {两撇}
杩	木 马
杪	木 小 丿
杭	木 亠 几
杯	木 不
杰	木 灬
杲	日 木
杳	木 日
杵	木 𠂉 十
杷	木 巴
杼	木 予
松	木 八 厶
板	木 ⺁ 又
极	木 乃 乀
构	木 勹 厶
枇	木 匕 匕
枉	木 王
枋	木 方
析	木 斤
枕	木 冖 儿
林	木 木
枘	木 冂 人
枚	木 夊
果	日 木
枝	木 十 又
枞	木 人 人
枢	木 匚 乂
枣	木 冂 ⺀
枥	木 厂 力
枧	木 见
枨	木 长
枪	木 人 㔾
枫	木 几 乂
枭	{鸟上} 木
枯	木 古
枰	木 干 丷
枳	木 口 八
枵	木 口 丂
架	力 口 木
枷	木 力 口
枸	木 勹 口
柁	木 宀 匕
柃	木 人 丶 マ
柄	木 一 冂 人
柏	木 白
某	卄 二 木
柑	木 卄 二
柒	氵 七 木
染	氵 九 木
柔	予 丿 木
柘	木 石
柙	木 甲
柚	木 由
柜	木 匚 コ
柝	木 斤 丶
柞	木 𠂉 {乍下}
柠	木 宀 丁
柢	木 {卬左} 七 丶
查	木 日 一
柩	木 匚 冖 丶
柬	木 囗 丷
柯	木 丁 口
柰	木 示
柱	木 丶 王
柳	木 卯
柴	止 匕 木
柽	木 又 土
柿	木 亠 巾
栀	木 ⺁ 一 㔾
栅	木 ⺆ ⺆ 一
标	木 示
栈	木 一 戈
栉	木 艹 卩
栊	木 尤 丿
栋	木 七 小
栌	木 卜 尸
栎	木 {乐上} 小
栏	木 䒑 二
树	木 又 寸
栓	木 人 王
栖	木 西
栗	西 木
栝	木 舌
校	木 亠 八 乂
栩	木 习 习
株	木 牛 八
栲	木 耂 丂
栳	木 耂 匕
样	木 羊
核	木 亥
根	木 艮
格	木 夊 口
栽	十 戈 木
栾	亦 木
桀	夕 ヰ 木
桁	木 彳 亍
桂	木 土 土
桃	木 儿 二 二
桄	木 小 兀
桅	木 冖 厂 㔾
框	木 匚 王
案	宀 女 木
桉	木 宀 女
桊	丷 夫 木
桌	卜 日 木
桎	木 至
桐	木 冂 一 口
桑	又 又 又 木
桓	木 一 日 一
桔	木 士 口
桕	木 臼
桠	木 丌 䒑
桡	木 七 丿 兀
桢	木 卜 贝
档	木 小 彐
桤	木 山 己
桥	木 夭 {介下}
桦	木 亻 匕 十
桧	木 人 二 厶
桨	丬 夕 木
桩	木 广 土
桫	木 氵 小 丿
桴	木 爪 子
桶	木 マ 用
桷	木 冖 用
梁	氵 刀 八 木
梃	木 壬 廴
梅	木 𠂉 母
梆	木 丰 阝
梏	木 ⺧ 口
梓	木 辛
梗	木 一 日 乂
梢	木 小 月
梦	木 木 夕
梧	木 一 {五下} 口
梨	禾 刂 木
梭	木 厶 八 夊
梯	木 丷 弓 丿
械	木 戈 卄
梳	木 亠 厶 {荒下}
梵	木 木 几 丶
检	木 人 一 {兴上}
棂	木 彐 火
棉	木 白 巾
棋	木 其
棍	木 日 匕 匕
棒	木 𡗗 キ
棕	木 宀 示
棘	木 冂 木 冂
棚	木 月 月
棠	尚 木
棣	木 彐 水
森	木 木 木
棰	木 壬 龷
棱	木 土 八 夊
棵	木 日 木
棹	木 卜 早
棺	木 宀 尸 コ
棼	木 木 八 刀
椁	木 {京頭} 子
椅	木 大 丁 口
椋	木 {京頭} 小
植	木 十 且
椎	木 隹
椐	木 尸 古
椒	木 上 小 又
椟	木 十 乛 大
椠	车 斤 木
椤	木 罒 夕
椭	木 阝 {左上} 月
椰	木 耳 阝
椴	木 亻 三 殳
椹	木 其 乚
椽	木 {互中} 豕
椿	木 𡗗 日
楂	木 木 日 一
楔	木 丰 刀 大
楗	木 彐 キ 廴
楚	木 木 乛 龰
楝	木 木 囗 丷
楞	木 罒 方
楠	木 十 冂 十
楣	木 {眉上} 目
楦	木 宀 一 一
楫	木 口 耳
楮	木 耂 日
楱	木 𡗗 一 大
楷	木 匕 匕 白
楸	木 禾 火
楹	木 乃 又 皿
楼	木 米 女
榀	木 口 口 口
概	木 彐 厶 儿
榄	木 〢 {⺮右} 见
榆	木 人 一 刂
榇	木 立 木
榈	木 门 口 口
榉	木 {兴上} 八 キ
榍	木 尸 小 月
榔	木 丶 彐 阝
榕	木 穴 人 口
榘	矢 匚 コ 木
榛	木 𡗗 禾
榜	木 亠 丷 方
榧	木 匚 非
榨	木 穴 𠂉 {乍下}
榫	木 隹 十
榭	木 身 寸
榱	木 {京頭} 一 𧘇
榴	木 卯 田
榷	木 冖 隹
榻	木 日 习 习
槁	木 高
槊	䒑 屮 月 木
槌	木 𠂤 辶
槎	木 羊 工
槐	木 鬼
槔	木 白 大 十
槛	木 〢 {⺮右} 皿
槟	木 宀 斤 八
槠	木 讠 耂 日
槭	木 戊 上 小
槲	木 冖 用 十
槽	木 艹 日 日
槿	木 革 二
樊	木 乂 乂 大
樗	木 雨 一 丂
樘	木 尚 土
樟	木 立 早
模	木 艹 日 大
樨	木 尸 水 牛
横	木 龷 由 八
樯	木 十 䒑 口
樱	木 贝 贝 女
樵	木 隹 灬
樽	木 丷 酉 寸
樾	木 走 戈 乚
橄	木 乛 耳 夊
橇	木 毛 毛 毛
橐	十 口 冖 木
橘	木 予 丿 口
橙	木 癶 一 䒑
橛	木 厂 䒑 欠
橡	木 冖 口 豕
橥	犭 耂 日 木
橱	木 厂 一 寸
橹	木 鱼 日
橼	木 纟 {互中} 豕
檀	木 亠 囗 一
檄	木 白 方 夊
檎	木 人 文 厶
檐	木 冖 厂 言
檑	木 雨 田
檗	尸 口 辛 木
檠	艹 勹 口 木
檩	木 亠 囗 示
檫	木 宀 {祭上} 示
檬	木 艹 冖 豕
欠	欠
次	二 欠
欢	又 欠
欣	斤 欠
欤	丂 一 欠
欧	匚 乂 欠
欲	八 人 口 欠
欷	乂 {左上} 巾 欠
欹	大 丁 口 欠
欺	其 欠
款	士 示 欠
歃	千 臼 欠
歆	立 日 欠
歇	日 勹 人 欠
歉	䒑 彐 〢 欠
歌	丁 口 丁 欠
歙	合 习 习 欠
止	止
正	一 止
此	止 匕
步	止 小
武	一 弋 止
歧	止 十 又
歪	不 一 止
歹	一 夕
死	一 夕 匕
歼	一 夕 千
殁	一 夕 殳
殂	一 夕 且
殃	一 夕 冂 大
殄	一 夕 人 彡
殆	一 夕 厶 口
殇	一 夕 𠂉 {两撇}
殉	一 夕 勹 日
殊	一 夕 牛 八
残	一 夕 一 戈
殍	一 夕 爪 子
殒	一 夕 口 贝
殓	一 夕 人 {兴上}
殖	一 夕 十 且
殚	一 夕 丷 十
殛	一 夕 了 一
殡	一 夕 宀 八
殪	一 夕 士 䒑
殳	殳
殴	匚 乂 殳
段	亻 三 殳
殷	⺁ 彐 乛 殳
殿	尸 龷 八 殳
毁	臼 工 殳
毂	{穀頭} 车
毅	立 豕 殳
毋	{母框} {左上}
母	母
每	𠂉 母
毒	龶 母
毓	𠂉 母 亠 {荒下}
比	匕 匕
毕	匕 匕 十
毖	匕 匕 心 丿
毗	田 匕 匕
毙	匕 匕 一 匕
毛	毛
毡	毛 卜 口
毪	毛 厶 牛
毫	{亮頭} 毛
毯	毛 火 火
毳	毛 毛 毛
毵	厶 大 彡 毛
毹	人 一 月 毛
毽	毛 彐 キ 廴
氅	尚 夊 毛
氆	毛 䒑 业 日
氇	毛 鱼 日
氍	目 目 隹 毛
氏	{卬左} 七
氐	{卬左} 七 丶
民	巳 七
氓	亡 巳 七
气	气
氕	气 丿
氖	气 乃
氘	气 {介下}
氙	气 山
氚	气 川
氛	气 八 刀
氟	气 弓 {介下}
氡	气 夊 ⺀
氢	气 ス 工
氤	气 囗 大
氦	气 亥
氧	气 羊
氨	气 宀 女
氩	气 丌 䒑
氪	气 古 儿
氮	气 火 火
氯	气 彐 水
氰	气 龶 月
氲	气 日 皿
水	水
氵	氵
永	丶 水
氽	人 水
汀	氵 丁
汁	氵 十
求	一 水 丶
汆	入 水
汇	氵 匚
汉	氵 又
汊	氵 又 丶
汐	氵 夕
汔	氵 𠂉 乙
汕	氵 山
汗	氵 干
汛	氵 乛 十
汜	氵 巳
汝	氵 女
汞	工 水
江	氵 工
池	氵 也
污	氵 一 丂
汤	氵 𠄎 {两撇}
汨	氵 日
汩	氵 曰
汪	氵 王
汰	氵 大 丶
汲	氵 乃 乀
汴	氵 亠 卜
汶	氵 文
汹	氵 乂 凵
汽	氵 气
汾	氵 八 刀
沁	氵 心
沂	氵 斤
沃	氵 夭
沅	氵 一 兀
沆	氵 亠 几
沈	氵 冖 儿
沉	氵 冖 几
沌	氵 七 凵
沏	氵 七 刀
沐	氵 木
沓	水 日
沔	氵 丅 乚 乛
沙	氵 小 丿
沛	氵 一 巾
沟	氵 勹 厶
没	氵 殳
沣	氵 丰
沤	氵 匚 乂
沥	氵 厂 力
沦	氵 人 匕
沧	氵 人 㔾
沩	氵 丶 力 丶
沪	氵 户
沫	氵 末
沭	氵 木 丶
沮	氵 且
沱	氵 宀 匕
沲	氵 𠂉 也
河	氵 丁 口
沸	氵 弓 {介下}
油	氵 由
治	氵 厶 口
沼	氵 刀 口
沽	氵 古
沾	氵 卜 口
沿	氵 几 口
泄	氵 世
泅	氵 囗 人
泉	白 水
泊	氵 白
泌	氵 心 丿
泐	氵 阝 力
泓	氵 弓 厶
泔	氵 卄 二
法	氵 土 厶
泖	氵 卯
泗	氵 囗 儿
泛	氵 丿 之
泞	氵 宀 丁
泠	氵 人 丶 マ
泡	氵 勹 巳
波	氵 皮
泣	氵 立
泥	氵 尸 匕
注	氵 丶 王
泪	氵 目
泫	氵 亠 幺
泮	氵 丷 キ
泯	氵 巳 七
泰	𡗗 水
泱	氵 冂 大
泳	氵 丶 水
泵	石 水
泶	⺍ 冖 水
泷	氵 尤 丿
泸	氵 卜 尸
泺	氵 {乐上} 小
泻	氵 冖 丂 一
泼	氵 丩 又 丶
泽	氵 又 キ
泾	氵 ス 工
洁	氵 士 口
洄	氵 囗 口
洇	氵 囗 大
洋	氵 羊
洌	氵 一 夕 刂
洎	氵 自
洒	氵 西
洗	氵 ⺧ 儿
洙	氵 牛 八
洚	氵 夊 ヰ
洛	氵 夊 口
洞	氵 冂 一 口
津	氵 彐 キ
洧	氵 {左上} 月
洪	氵 龷 八
洫	氵 丿 皿
洮	氵 儿 二 二
洱	氵 耳
洲	氵 ⺍ 川
洳	氵 女 口
洵	氵 勹 日
洹	氵 一 日 一
活	氵 舌
洼	氵 土 土
洽	氵 合
派	氵 ⺁ 𧘇
流	氵 亠 厶 {荒下}
浃	氵 夫 丷
浅	氵 一 戈
浆	丬 夕 水
浇	氵 七 丿 兀
浈	氵 卜 贝
浊	氵 虫
测	氵 贝 刂
浍	氵 人 二 厶
济	氵 文 {介下}
浏	氵 文 刂
浑	氵 冖 车
浒	氵 讠 𠂉 十
浓	氵 冖 𧘇
浔	氵 彐 寸
浙	氵 扌 斤
浚	氵 厶 八 夊
浜	氵 斤 一 八
浞	氵 足
浠	氵 乂 {左上} 巾
浣	氵 宀 一 兀
浦	氵 甫
浩	氵 ⺧ 口
浪	氵 丶 艮
浮	氵 爪 子
浯	氵 一 {五下} 口
浴	氵 八 人 口
海	氵 𠂉 母
浸	氵 彐 冖 又
浼	氵 冖 口 儿
涂	氵 人 一 木
涅	氵 日 土
消	氵 小 月
涉	氵 止 小
涌	氵 マ 用
涎	氵 丿 止 廴
涑	氵 木 口
涓	氵 口 月
涔	氵 山 人 乛
涕	氵 丷 弓 丿
涛	氵 丰 寸
涝	氵 艹 冖 力
涞	氵 一 米
涟	氵 车 辶
涠	氵 囗 キ 乛
涡	氵 口 冂 人
涣	氵 冖 冂 大
涤	氵 夊 木
润	氵 门 王
涧	氵 门 日
涨	氵 弓 长
涩	氵 刀 丶 止
涪	氵 立 口
涫	氵 宀 尸 コ
涮	氵 尸 巾 刂
涯	氵 厂 土 土
液	氵 亠 亻 乀
涵	氵 乛 水 凵
涸	氵 囗 古
涿	氵 豕 丶
淀	氵 宀 一 龰
淄	氵 巛 田
淅	氵 木 斤
淆	氵 乂 {左上} 月
淇	氵 其
淋	氵 木 木
淌	氵 尚
淑	氵 上 小 又
淖	氵 卜 早
淘	氵 勹 缶
淙	氵 宀 示
淝	氵 月 巴
淞	氵 木 八 厶
淠	氵 田 丌
淡	氵 火 火
淤	氵 方 人 ⺀
淦	氵 金
淫	氵 爪 壬
淬	氵 亠 人 十
淮	氵 隹
深	氵 冖 八 木
淳	氵 {京頭} 子
混	氵 日 匕 匕
淹	氵 大 电
添	氵 一 大 丶
淼	水 水 水
清	氵 龶 月
渊	氵 {介下} 米
渌	氵 彐 水
渍	氵 龶 贝
渎	氵 十 乛 大
渐	氵 车 斤
渑	氵 口 电
渔	氵 鱼
渖	氵 宀 申
渗	氵 厶 大 彡
渚	氵 耂 日
渝	氵 人 一 刂
渠	氵 匚 コ 木
渡	氵 广 卄 又
渣	氵 木 日 一
渤	氵 十 冖 力
渥	氵 尸 至
温	氵 日 皿
渫	氵 世 木
渭	氵 田 月
港	氵 龷 八 巳
渲	氵 宀 一 一
渴	氵 日 勹 乚
游	氵 方 𠂉 子
渺	氵 目 小 丿
湃	氵 龵 一 丰
湄	氵 {眉上} 目
湍	氵 山 而
湎	氵 面
湓	氵 八 刀 皿
湔	氵 䒑 月 刂
湖	氵 古 月
湘	氵 木 目
湛	氵 其 乚
湟	氵 白 王
湫	氵 禾 火
湮	氵 西 土
湾	氵 亦 弓
湿	氵 日 业
溃	氵 口 丄 贝
溅	氵 贝 一 戈
溆	氵 人 一 又
溉	氵 彐 厶 儿
溏	氵 广 肀 口
源	氵 厂 白 小
溘	氵 土 厶 皿
溜	氵 卯 田
溟	氵 冖 日 八
溢	氵 䒑 八 皿
溥	氵 甫 寸
溧	氵 西 木
溪	氵 爪 幺 大
溯	氵 䒑 屮 月
溱	氵 𡗗 禾
溲	氵 臼 丨 又
溴	氵 自 犬
溶	氵 穴 人 口
溷	氵 囗 豕
溺	氵 弓 二 二
溻	氵 日 习 习
溽	氵 辰 寸
滁	氵 阝 人 木
滂	氵 亠 丷 方
滇	氵 十 且 八
滋	氵 䒑 幺 幺
滏	氵 八 乂 䒑
滑	氵 骨
滓	氵 宀 辛
滔	氵 爪 臼
滕	月 丷 夫 水
滗	氵 竹 毛
滚	氵 亠 八 𧘇
滞	氵 卅 冖 巾
滟	氵 丰 冖 巴
滠	氵 耳 又 又
满	氵 艹 一 人
滢	氵 艹 冖 丶
滤	氵 {虎头} 心
滥	氵 〢 {⺮右} 皿
滦	氵 亦 木
滨	氵 宀 斤 八
滩	氵 又 隹
滴	氵 亠 丷 古
滹	氵 {虎头} 丿 {于下}
漂	氵 西 示
漆	氵 木 人 水
漉	氵 鹿
漏	氵 尸 雨
漓	氵 文 凵 厶
演	氵 宀 一 八
漕	氵 艹 日 日
漠	氵 艹 日 大
漤	氵 木 木 女
漩	氵 方 𠂉 龰
漪	氵 犭 大 口
漫	氵 日 罒 又
漭	氵 艹 犬 卄
漯	氵 田 糸
漱	氵 木 口 欠
漳	氵 立 早
漶	氵 口 口 心
漾	氵 羊 丶 水
潆	氵 艹 冖 糸
潇	氵 艹 肀 八
潋	氵 人 一 夊
潍	氵 纟 隹
潘	氵 丿 米 田
潜	氵 夫 夫 日
潞	氵 足 夊 口
潢	氵 龷 由 八
潦	氵 大 丷 小
潭	氵 西 早
潮	氵 十 早 月
潲	氵 禾 小 月
潴	氵 犭 耂 日
潸	氵 木 木 月
潺	氵 尸 子 子
潼	氵 立 里
澄	氵 癶 一 䒑
澈	氵 亠 厶 夊
澉	氵 乛 耳 夊
澌	氵 其 斤
澍	氵 士 口 寸
澎	氵 士 口 彡
澜	氵 门 木 丷
澡	氵 口 口 木
澧	氵 冂 龷 䒑
澳	氵 {向框} 米 大
澶	氵 亠 囗 一
澹	氵 冖 厂 言
激	氵 白 方 夊
濂	氵 广 䒑 八
濉	氵 目 隹
濑	氵 木 口 贝
濒	氵 止 小 贝
濞	氵 自 田 丌
濠	氵 {亮頭} 豕
濡	氵 雨 而
濮	氵 亻 业 夫
濯	氵 习 习 隹
瀑	氵 日 龷 水
瀚	氵 十 早 习
瀛	氵 {贏頭} 女
瀣	氵 卜 夕 一
瀵	氵 米 田 八
瀹	氵 合 口 冊
灌	氵 艹 口 隹
灏	氵 日 {京頭} 贝
灞	氵 雨 革 月
火	火
灬	灬
灭	一 火
灯	火 丁
灰	{左上} 火
灵	彐 火
灶	火 土
灸	冖 丶 火
灼	火 勹 丶
灾	宀 火
灿	火 山
炀	火 𠄎 {两撇}
炅	日 火
炉	火 户
炊	火 欠
炎	火 火
炒	火 小 丿
炔	火 コ 人
炕	火 亠 几
炖	火 七 凵
炙	月 火
炜	火 キ 乛
炝	火 人 㔾
炫	火 亠 幺
炬	火 匚 コ
炭	山 {左上} 火
炮	火 勹 巳
炯	火 冂 口
炱	厶 口 火
炳	火 一 冂 人
炷	火 丶 王
炸	火 𠂉 {乍下}
点	卜 口 灬
炻	火 石
炼	火 七 乛 八
炽	火 口 八
烀	火 丿 丷 {于下}
烁	火 {乐上} 小
烂	火 䒑 二
烃	火 ス 工
烈	一 夕 刂 灬
烊	火 羊
烘	火 龷 八
烙	火 夊 口
烛	火 虫
烟	火 囗 大
烤	火 耂 丂
烦	火 丆 贝
烧	火 七 丿 兀
烨	火 亻 匕 十
烩	火 人 二 厶
烫	氵 𠄎 {两撇} 火
烬	火 尸 乀 ⺀
热	扌 九 丶 灬
烯	火 乂 {左上} 巾
烷	火 宀 一 兀
烹	{京頭} 了 灬
烽	火 夊 丰
焉	一 止 丂 灬
焊	火 日 干
焐	火 一 {五下} 口
焓	火 人 丶 口
焕	火 冖 冂 大
焖	火 门 心
焘	丰 寸 灬
焙	火 立 口
焚	木 木 火
焦	隹 灬
焯	火 卜 早
焰	火 冖 臼
焱	火 火 火
然	月 犬 灬
煅	火 亻 三 殳
煊	火 宀 一 一
煌	火 白 王
煎	䒑 月 刂 灬
煜	火 日 立
煞	冖 彐 夊 灬
煤	火 卄 二 木
煦	日 勹 口 灬
照	日 刀 口 灬
煨	火 田 {畏下}
煮	耂 日 灬
煲	亻 口 木 火
煳	火 古 月
煸	火 户 冊
煺	火 艮 辶
煽	火 户 习 习
熄	火 自 心
熊	厶 月 匕 灬
熏	千 黑
熔	火 穴 人 口
熘	火 卯 田
熙	臣 巳 灬
熟	{京頭} 子 九 灬
熠	火 习 习 白
熨	尸 示 寸 火
熬	龶 勹 夊 灬
熳	火 日 罒 又
熵	火 亠 丷 口
熹	士 口 䒑 灬
燃	火 月 犬 灬
燎	火 大 丷 小
燔	火 丿 米 田
燕	卄 一 口 灬
燠	火 {向框} 米 大
燥	火 口 口 木
燧	火 䒑 豕 辶
燮	言 火 火 又
燹	豕 豕 火
爆	火 日 龷 水
爝	火 爪 罒 寸
爨	臼 冂 一 火
爪	爪
爬	爪 巴
爰	爪 干 又
爱	爪 冖 {左上} 又
爵	爪 罒 彐 寸
父	八 乂
爷	八 乂 卩
爸	八 乂 巴
爹	八 乂 夕 夕
爻	乂 乂
爽	大 乂 乂 乂
爿	爿
片	片
版	片 ⺁ 又
牌	片 {卑上} 十
牍	片 十 乛 大
牒	片 世 木
牖	片 户 甫
牙	牙
牛	牛
牝	牛 匕
牟	厶 牛
牡	牛 土
牢	宀 牛
牦	牛 毛
牧	牛 夊
物	牛 勹 {两撇}
牮	亻 弋 牛
牯	牛 古
牲	牛 生
牵	大 冖 牛
特	牛 土 寸
牺	牛 西
牾	牛 一 {五下} 口
牿	牛 ⺧ 口
犀	尸 水 牛
犁	禾 刂 牛
犄	牛 大 丁 口
犊	牛 十 乛 大
犋	牛 且 八
犍	牛 彐 キ 廴
犏	牛 户 冊
犒	牛 高
犟	弓 口 虫 牛
犬	犬
犭	犭
犯	犭 㔾
犰	犭 九
犴	犭 干
状	丬 犬
犷	犭 广
犸	犭 马
犹	犭 尤
狁	犭 厶 儿
狂	犭 王
狃	犭 丑
狄	犭 火
狈	犭 贝
狍	犭 勹 巳
狎	犭 甲
狐	犭 瓜
狒	犭 弓 {介下}
狗	犭 勹 口
狙	犭 且
狞	犭 宀 丁
狠	犭 艮
狡	犭 亠 八 乂
狨	犭 戈 {左上}
狩	犭 宀 寸
独	犭 虫
狭	犭 夫 丷
狮	犭 リ 一 巾
狯	犭 人 二 厶
狰	犭 冖 彐 亅
狱	犭 讠 犬
狲	犭 子 小
狳	犭 人 一 木
狴	犭 匕 匕 土
狷	犭 口 月
狸	犭 里
狺	犭 言
狻	犭 厶 八 夊
狼	犭 丶 艮
猁	犭 禾 刂
猃	犭 人 一 {兴上}
猊	犭 臼 儿
猎	犭 龷 日
猓	犭 日 木
猕	犭 弓 冖 小
猖	犭 日 日
猗	犭 大 丁 口
猛	犭 子 皿
猜	犭 龶 月
猝	犭 亠 人 十
猞	犭 人 干 口
猡	犭 罒 夕
猢	犭 古 月
猥	犭 田 {畏下}
猩	犭 日 生
猪	犭 耂 日
猫	犭 艹 田
猬	犭 田 月
献	十 冂 䒑 犬
猱	犭 予 丿 木
猴	犭 亻 コ 矢
猷	丷 酉 犬
猸	犭 {眉上} 目
猹	犭 木 日 一
猾	犭 骨
猿	犭 土 口 𧘇
獍	犭 立 日 儿
獐	犭 立 早
獒	龶 勹 夊 犬
獗	犭 厂 䒑 欠
獠	犭 大 丷 小
獬	犭 冖 用 牛
獭	犭 木 口 贝
獯	犭 千 黑
獾	犭 艹 口 隹
玄	亠 幺
率	亠 幺 二 十
玉	王 丶
王	王
玎	王 丁
玑	王 几
玖	王 冖 丶
玛	王 马
玟	王 文
玢	王 八 刀
玩	王 一 兀
玫	王 夊
玮	王 キ 乛
环	王 不
现	王 见
玲	王 人 丶 マ
玳	王 亻 弋
玷	王 卜 口
玺	冖 小 王 丶
玻	王 皮
珀	王 白
珂	王 丁 口
珈	王 力 口
珉	王 巳 七
珊	王 ⺆ ⺆ 一
珍	王 人 彡
珏	王 王 丶
珐	王 土 厶
珑	王 尤 丿
珙	王 龷 八
珞	王 夊 口
珠	王 牛 八
珥	王 耳
珧	王 儿 二 二
珩	王 彳 亍
班	王 リ 王
珲	王 冖 车
球	王 一 水 丶
琅	王 丶 艮
理	王 里
琉	王 亠 厶 {荒下}
琊	王 牙 阝
琏	王 车 辶
琐	王 小 贝
琚	王 尸 古
琛	王 冖 八 木
琢	王 豕 丶
琥	王 虎
琦	王 大 丁 口
琨	王 日 匕 匕
琪	王 其
琬	王 宀 夕 㔾
琮	王 宀 示
琰	王 火 火
琳	王 木 木
琴	王 王 人 乛
琵	王 王 匕 匕
琶	王 王 巴
琼	王 {京頭} 小
瑁	王 冂 二 目
瑕	王 尸 二 又
瑗	王 爪 干 又
瑙	王 巛 {囟框} 乂
瑚	王 古 月
瑛	王 艹 冂 大
瑜	王 人 一 刂
瑞	王 山 而
瑟	王 王 心 丿
瑭	王 广 肀 口
瑰	王 鬼
瑶	王 爪 缶
瑷	王 爪 冖 又
瑾	王 革 二
璀	王 山 隹
璁	王 {囟框} 夊 心
璃	王 文 凵 厶
璇	王 方 𠂉 龰
璋	王 立 早
璎	王 贝 贝 女
璐	王 足 夊 口
璜	王 龷 由 八
璞	王 业 䒑 夫
璧	尸 口 辛 丶
璨	王 卜 夕 米
璩	王 {虎头} 豕
璺	臼 冂 一 丶
瓒	王 ⺧ 儿 贝
瓜	瓜
瓞	瓜 丿 夫
瓠	大 一 丂 瓜
瓢	西 示 瓜
瓣	辛 瓜 辛
瓤	{京頭} 口 {冓上} 瓜
瓦	瓦
瓮	八 厶 瓦
瓯	匚 乂 瓦
瓴	人 丶 マ 瓦
瓶	䒑 卄 瓦
瓷	二 欠 瓦
瓿	立 口 瓦
甄	西 土 瓦
甍	艹 罒 冖 瓦
甏	士 口 䒑 瓦
甑	丷 日 丷 瓦
甓	尸 口 辛 瓦
甘	卄 二
甙	弋 卄 二
甚	其 乚
甜	舌 卄 二
生	生
甥	生 田 力
用	用
甩	月 乚
甫	甫
甬	マ 用
甭	不 用
甯	宀 心 用
田	田
由	由
甲	甲
申	申
电	电
男	田 力
甸	勹 田
町	田 丁
画	一 田 凵
甾	巛 田
畀	田 丌
畅	申 𠄎 {两撇}
畈	田 ⺁ 又
畋	田 夊
界	田 人 {介下}
畎	田 犬
畏	田 {畏下}
畔	田 丷 キ
留	卯 田
畚	厶 大 田
畛	田 人 彡
畜	亠 幺 田
略	田 夊 口
畦	田 土 土
番	丿 米 田
畲	人 示 田
畴	田 丰 寸
畸	田 大 丁 口
畹	田 宀 夕 㔾
畿	幺 幺 戈 田
疃	田 立 里
疆	弓 土 一 一
疋	乛 龰
疏	乛 止 亠 {荒下}
疑	匕 矢 マ 龰
疒	疒
疔	疒 丁
疖	疒 卩
疗	疒 了
疙	疒 𠂉 乙
疚	疒 冖 丶
疝	疒 山
疟	疒 {反彐}
疠	疒 一 勹
疡	疒 𠄎 {两撇}
疣	疒 尤
疤	疒 巴
疥	疒 人 {介下}
疫	疒 殳
疬	疒 厂 力
疮	疒 人 㔾
疯	疒 几 乂
疰	疒 丶 王
疱	疒 勹 巳
疲	疒 皮
疳	疒 卄 二
疴	疒 丁 口
疵	疒 止 匕
疸	疒 日 一
疹	疒 人 彡
疼	疒 夊 ⺀
疽	疒 且
疾	疒 矢
痂	疒 力 口
痃	疒 亠 幺
痄	疒 𠂉 {乍下}
病	疒 一 冂 人
症	疒 一 止
痈	疒 用
痉	疒 ス 工
痊	疒 人 王
痍	疒 大 弓
痒	疒 羊
痔	疒 土 寸
痕	疒 艮
痖	疒 丌 䒑
痘	疒 一 口 䒑
痛	疒 マ 用
痞	疒 不 口
痢	疒 禾 刂
痣	疒 士 心
痤	疒 人 人 土
痦	疒 一 {五下} 口
痧	疒 氵 小 丿
痨	疒 艹 冖 力
痪	疒 冖 冂 大
痫	疒 门 木
痰	疒 火 火
痱	疒 非
痴	疒 矢 口
痹	疒 田 丌
痼	疒 囗 古
痿	疒 禾 女
瘀	疒 方 人 ⺀
瘁	疒 亠 人 十
瘃	疒 豕 丶
瘅	疒 丷 日 十
瘊	疒 亻 コ 矢
瘌	疒 木 口 刂
瘐	疒 臼 人
瘕	疒 尸 二 又
瘗	疒 夫 丷 土
瘘	疒 米 女
瘙	疒 又 丶 虫
瘛	疒 丰 刀 心
瘟	疒 日 皿
瘠	疒 二 二 月
瘢	疒 舟 殳
瘤	疒 卯 田
瘥	疒 羊 工
瘦	疒 臼 丨 又
瘩	疒 艹 合
瘪	疒 自 人 匕
瘫	疒 又 隹
瘭	疒 西 示
瘰	疒 田 糸
瘳	疒 习 习 彡
瘴	疒 立 早
瘵	疒 {祭上} 示
瘸	疒 力 口 人
瘼	疒 艹 日 大
瘾	疒 阝 冖 心
瘿	疒 贝 贝 女
癀	疒 龷 由 八
癃	疒 阝 夊 生
癌	疒 口 口 山
癍	疒 王 文 王
癔	疒 立 日 心
癖	疒 尸 口 辛
癜	疒 尸 龷 殳
癞	疒 木 口 贝
癣	疒 鱼 羊
癫	疒 十 且 贝
癯	疒 目 目 隹
癸	癶 一 大
登	癶 一 口 䒑
白	白
百	丆 日
皂	白 七
的	白 勹 丶
皆	匕 匕 白
皇	白 王
皈	白 ⺁ 又
皋	白 大 十
皎	白 亠 八 乂
皑	白 山 己
皓	白 ⺧ 口
皖	白 宀 一 兀
皙	木 斤 白
皤	白 丿 米 田
皮	皮
皱	冖 彐 皮
皲	冖 车 皮
皴	厶 八 夊 皮
皿	皿
盂	一 {于下} 皿
盅	口 丨 皿
盆	八 刀 皿
盈	乃 又 皿
益	䒑 八 皿
盍	土 厶 皿
盎	冂 大 皿
盏	一 戈 皿
盐	土 卜 皿
监	〢 {⺮右} 皿
盒	合 皿
盔	{左上} 火 皿
盖	羊 皿
盗	二 欠 皿
盘	舟 皿
盛	戊 乛 皿
盟	日 月 皿
盥	臼 水 皿
目	目
盯	目 丁
盱	目 一 {于下}
盲	亡 目
直	十 且
相	木 目
盹	目 七 凵
盼	目 八 刀
盾	⺁ 十 目
省	小 丿 目
眄	目 丅 乚 乛
眇	目 小 丿
眈	目 冖 儿
眉	{眉上} 目
看	龵 目
眍	目 匚 乂
眙	目 厶 口
眚	生 目
真	十 且 八
眠	目 巳 七
眢	夕 㔾 目
眦	目 止 匕
眨	目 丿 之
眩	目 亠 幺
眭	目 土 土
眯	目 米
眵	目 夕 夕
眶	目 匚 王
眷	丷 夫 目
眸	目 厶 牛
眺	目 儿 二 二
眼	目 艮
着	羊 目
睁	目 冖 彐 亅
睃	目 厶 八 夊
睇	目 丷 弓 丿
睐	目 一 米
睑	目 人 一 {兴上}
睚	目 厂 土 土
睛	目 龶 月
睡	目 壬 龷
睢	目 隹
督	上 小 又 目
睥	目 {卑上} 十
睦	目 土 八 土
睨	目 臼 儿
睫	目 一 彐 龰
睬	目 爪 木
睹	目 耂 日
睽	目 癶 一 大
睾	丿 罒 土 十
睿	卜 冖 一 目
瞀	予 丿 夊 目
瞄	目 艹 田
瞅	目 禾 火
瞌	目 土 厶 皿
瞍	目 臼 丨 又
瞎	目 宀 丰 口
瞑	目 冖 日 八
瞒	目 艹 一 人
瞟	目 西 示
瞠	目 尚 土
瞢	艹 罒 冖 目
瞥	丷 巾 八 目
瞧	目 隹 灬
瞩	目 尸 丿 冂
瞪	目 癶 一 䒑
瞬	目 爪 冖 ヰ
瞰	目 乛 耳 夊
瞳	目 立 里
瞵	目 米 夕 ヰ
瞻	目 冖 厂 言
瞽	士 口 䒑 目
瞿	目 目 隹
矍	目 目 隹 又
矗	十 且 十 且
矛	予 丿
矜	予 丿 人 乛
矢	矢
矣	厶 矢
知	矢 口
矧	矢 弓 丨
矩	矢 匚 コ
矫	矢 夭 {介下}
矬	矢 人 人 土
短	矢 一 口 䒑
矮	矢 禾 女
石	石
矶	石 几
矸	石 干
矽	石 夕
矾	石 几 丶
矿	石 广
砀	石 𠄎 {两撇}
码	石 马
砂	石 小 丿
砉	丰 石
砌	石 七 刀
砍	石 欠
砑	石 牙
砒	石 匕 匕
研	石 一 卄
砖	石 二 ㇉ 丶
砗	石 车
砘	石 七 凵
砚	石 见
砜	石 几 乂
砝	石 土 厶
砟	石 𠂉 {乍下}
砣	石 宀 匕
砥	石 {卬左} 七 丶
砦	止 匕 石
砧	石 卜 口
砩	石 弓 {介下}
砬	石 立
砭	石 丿 之
砰	石 干 丷
破	石 皮
砷	石 申
砸	石 匚 巾
砹	石 艹 乂
砺	石 厂 一 勹
砻	尤 丿 石
砼	石 人 工
砾	石 {乐上} 小
础	石 屮 凵
硅	石 土 土
硇	石 {囟框} 乂
硌	石 夊 口
硎	石 一 卄 刂
硐	石 冂 一 口
硒	石 西
硕	石 丆 贝
硖	石 夫 丷
硗	石 七 丿 兀
硝	石 小 月
硪	石 丿 扌 戈
硫	石 亠 厶 {荒下}
硬	石 一 日 乂
硭	石 艹 亡
确	石 冖 用
硷	石 人 一 {兴上}
硼	石 月 月
碇	石 宀 一 龰
碉	石 ⺆ 土 口
碌	石 彐 水
碍	石 日 一 寸
碎	石 亠 人 十
碑	石 {卑上} 十
碓	石 隹
碗	石 宀 夕 㔾
碘	石 冂 龷 八
碚	石 立 口
碛	石 龶 贝
碜	石 厶 大 彡
碟	石 世 木
碡	石 龶 母
碣	石 日 勹 乚
碥	石 户 冊
碧	王 白 石
碰	石 䒑 业
碱	石 戊 一 口
碲	石 亠 丷 巾
碳	石 山 {左上} 火
碴	石 木 日 一
碹	石 宀 一 一
碾	石 尸 艹 {畏下}
磁	石 䒑 幺 幺
磅	石 亠 丷 方
磉	石 又 又 木
磊	石 石 石
磋	石 羊 工
磐	舟 殳 石
磔	石 夕 ヰ 木
磕	石 土 厶 皿
磙	石 亠 八 𧘇
磨	麻 石
磬	士 {眉上} 殳 石
磲	石 氵 匚 木
磴	石 癶 一 䒑
磷	石 米 夕 ヰ
磺	石 龷 由 八
礁	石 隹 灬
礅	石 {京頭} 子 夊
礓	石 一 田 一
礞	石 艹 冖 豕
礤	石 艹 {祭上} 示
礴	石 艹 氵 寸
示	示
礻	示
礼	示 乚
社	示 土
祀	示 巳
祁	示 阝
祆	示 一 大
祈	示 斤
祉	示 止
祓	示 {左上} 又 丶
祖	示 且
祗	示 {卬左} 七 丶
祚	示 𠂉 {乍下}
祛	示 土 厶
祜	示 古
祝	示 口 儿
神	示 申
祟	屮 凵 示
祠	示 乛 一 口
祢	示 冖 小
祥	示 羊
祧	示 儿 二 二
票	西 示
祭	{祭上} 示
祯	示 卜 贝
祷	示 丰 寸
祸	示 口 冂 人
祺	示 其
禀	亠 囗 口 示
禁	木 木 示
禄	示 彐 水
禅	示 丷 日 十
禊	示 丰 刀 大
福	示 一 口 田
禚	示 羊 灬
禧	示 士 口 口
禳	示 {京頭} 口 𧘇
禹	丿 虫 冂
禺	禺
离	文 凵 冂 厶
禽	人 文 凵 厶
禾	禾
秀	禾 乃
私	禾 厶
秃	禾 几
秆	禾 干
秉	禾 彐
秋	禾 火
种	禾 口 丨
科	禾 ⺀ 十
秒	禾 小 丿
秕	禾 匕 匕
秘	禾 心 丿
租	禾 且
秣	禾 末
秤	禾 干 丷
秦	𡗗 禾
秧	禾 冂 大
秩	禾 丿 夫
秫	禾 木 丶
秭	禾 丿 ㇉ 丿
积	禾 口 八
称	禾 冖 小
秸	禾 士 口
移	禾 夕 夕
秽	禾 山 夕
稀	禾 乂 {左上} 巾
稂	禾 丶 艮
稃	禾 爪 子
稆	禾 口 口
程	禾 口 王
稍	禾 小 月
税	禾 丷 口 儿
稔	禾 人 丶 心
稗	禾 {卑上} 十
稚	禾 隹
稞	禾 日 木
稠	禾 ⺆ 土 口
稣	鱼 禾
稳	禾 冖 彐 心
稷	禾 田 八 夊
稹	禾 十 且 八
稻	禾 爪 臼
稼	禾 宀 豕
稽	禾 尤 匕 日
稿	禾 高
穆	禾 白 小 彡
穑	禾 十 䒑 口
穗	禾 {專上} 心
穰	禾 {京頭} 口 𧘇
穴	穴
究	穴 九
穷	穴 力
穸	穴 夕
穹	穴 弓
空	穴 工
穿	穴 牙
窀	穴 七 凵
突	穴 犬
窃	穴 七 刀
窄	穴 𠂉 {乍下}
窆	穴 丿 之
窈	穴 幺 力
窍	穴 工 丂
窑	穴 缶
窒	穴 至
窕	穴 儿 二 二
窖	穴 ⺧ 口
窗	穴 {囟框} 夊
窘	穴 彐 丿 口
窜	穴 口 口 丨
窝	穴 口 冂 人
窟	穴 尸 屮 凵
窠	穴 日 木
窥	穴 夫 见
窦	穴 十 乛 大
窨	穴 立 日
窬	穴 人 一 刂
窭	穴 米 女
窳	穴 瓜 瓜
窿	穴 阝 夊 生
立	立
竖	〢 又 立
站	立 卜 口
竞	立 口 儿
竟	立 日 儿
章	立 早
竣	立 厶 八 夊
童	立 里
竦	立 木 口
竭	立 日 勹 乚
端	立 山 而
竹	竹
竺	竹 二
竽	竹 一 {于下}
竿	竹 干
笃	竹 马
笄	竹 一 卄
笆	竹 巴
笈	竹 乃 乀
笊	竹 爪
笋	竹 彐 丿
笏	竹 勹 {两撇}
笑	竹 夭
笔	竹 毛
笕	竹 见
笙	竹 生
笛	竹 由
笞	竹 厶 口
笠	竹 立
笤	竹 刀 口
笥	竹 乛 一 口
符	竹 亻 寸
笨	竹 木 一
笪	竹 日 一
笫	竹 丿 ㇉ 丿
第	竹 弓 丨 丿
笮	竹 𠂉 {乍下}
笱	竹 勹 口
笳	竹 力 口
笸	竹 匚 口
笺	竹 一 戈
笼	竹 尤 丿
笾	竹 力 辶
筅	竹 ⺧ 儿
筇	竹 工 阝
等	竹 土 寸
筋	竹 月 力
筌	竹 人 王
筏	竹 亻 戈
筐	竹 匚 王
筑	竹 工 几 丶
筒	竹 冂 一 口
答	竹 合
策	竹 木 冂
筘	竹 扌 口
筚	竹 匕 匕 十
筛	竹 リ 一 巾
筝	竹 冖 彐 亅
筠	竹 土 勹 二
筢	竹 扌 巴
筮	竹 工 人 人
筱	竹 亻 丨 夊
筲	竹 小 月
筵	竹 丿 止 廴
筷	竹 忄 コ 人
筹	竹 丰 寸
筻	竹 一 日 乂
签	竹 人 一 {兴上}
简	竹 门 日
箅	竹 田 丌
箍	竹 扌 匚 巾
箐	竹 龶 月
箔	竹 氵 白
箕	竹 其
算	竹 目 卄
箜	竹 穴 工
箝	竹 扌 卄 二
管	竹 宀 尸 コ
箢	竹 宀 夕 㔾
箦	竹 龶 贝
箧	竹 匚 夫 丷
箨	竹 扌 又 キ
箩	竹 罒 夕
箪	竹 丷 日 十
箫	竹 肀 {介下} 八
箬	竹 艹 {左上} 口
箭	竹 䒑 月 刂
箱	竹 木 目
箴	竹 戊 一 口
箸	竹 耂 日
篁	竹 白 王
篆	竹 {互中} 豕
篇	竹 户 冊
篌	竹 亻 コ 矢
篑	竹 口 丄 贝
篓	竹 米 女
篙	竹 高
篚	竹 匚 非
篝	竹 {冓上} 冂 土
篡	竹 目 大 厶
篥	竹 西 木
篦	竹 {囟框} 乂 匕
篪	竹 ⺁ 虎
篮	竹 〢 {⺮右} 皿
篱	竹 文 凵 厶
篷	竹 夊 丰 辶
篼	竹 白 {卬左} 儿
篾	竹 罒 戊 丶
簇	竹 方 𠂉 矢
簋	竹 艮 皿
簌	竹 木 口 欠
簏	竹 鹿
簖	竹 米 乚 斤
簟	竹 西 早
簦	竹 癶 一 䒑
簧	竹 龷 由 八
簪	竹 匚 儿 日
簸	竹 其 皮
簿	竹 氵 甫 寸
籀	竹 扌 卯 田
籁	竹 木 口 贝
籍	竹 丰 八 日
米	米
籴	入 米
类	米 大
籼	米 山
籽	米 子
粉	米 八 刀
粑	米 巴
粒	米 立
粕	米 白
粗	米 且
粘	米 卜 口
粜	屮 凵 米
粝	米 厂 一 勹
粞	米 西
粟	西 米
粢	二 欠 米
粤	{囟框} 米 丂
粥	弓 米 弓
粪	米 龷 八
粮	米 丶 艮
粱	氵 刀 八 米
粲	卜 夕 又 米
粳	米 一 日 乂
粹	米 亠 人 十
粼	米 夕 ヰ 巜
粽	米 宀 示
精	米 龶 月
糁	米 厶 大 彡
糅	米 予 丿 木
糇	米 亻 コ 矢
糈	米 乛 龰 月
糊	米 古 月
糌	米 夊 卜 日
糍	米 䒑 幺 幺
糕	米 羊 灬
糖	米 广 肀 口
糗	米 自 犬
糙	米 ⺧ 口 辶
糜	麻 米
糟	米 艹 日 日
糠	米 广 彐 水
糨	米 弓 口 虫
糯	米 雨 而
糸	糸
系	丿 糸
紊	文 糸
素	龶 糸
索	十 冖 糸
紧	〢 又 糸
紫	止 匕 糸
累	田 糸
絮	女 口 糸
絷	扌 九 丶 糸
綦	其 糸
綮	户 夊 糸
縻	麻 糸
繁	𠂉 母 夊 糸
繇	爪 缶 丿 糸
纂	竹 目 大 糸
纛	龶 母 且 糸
纟	纟
纠	纟 丩
纡	纟 一 {于下}
红	纟 工
纣	纟 寸
纤	纟 千
纥	纟 𠂉 乙
约	纟 勹 丶
级	纟 乃 乀
纨	纟 九 丶
纩	纟 广
纪	纟 己
纫	纟 刀 丶
纬	纟 キ 乛
纭	纟 二 厶
纯	纟 七 凵
纰	纟 匕 匕
纱	纟 小 丿
纲	纟 冂 乂
纳	纟 冂 人
纵	纟 人 人
纶	纟 人 匕
纷	纟 八 刀
纸	纟 {卬左} 七
纹	纟 文
纺	纟 方
纽	纟 丑
纾	纟 予
线	纟 一 戈
绀	纟 卄 二
绁	纟 世
绂	纟 {左上} 又 丶
练	纟 七 乛 八
组	纟 且
绅	纟 申
细	纟 田
织	纟 口 八
终	纟 夊 ⺀
绉	纟 冖 彐
绊	纟 丷 キ
绋	纟 弓 {介下}
绌	纟 屮 凵
绍	纟 刀 口
绎	纟 又 キ
经	纟 ス 工
绐	纟 厶 口
绑	纟 丰 阝
绒	纟 戈 {左上}
结	纟 士 口
绔	纟 大 一 丂
绕	纟 七 丿 兀
绗	纟 彳 亍
绘	纟 人 二 厶
给	纟 合
绚	纟 勹 日
绛	纟 夊 ヰ
络	纟 夊 口
绝	纟 冖 巴
绞	纟 亠 八 乂
统	纟 亠 厶 儿
绠	纟 一 日 乂
绡	纟 小 月
绢	纟 口 月
绣	纟 禾 乃
绥	纟 爪 女
绦	纟 夊 木
继	纟 米 乚
绨	纟 丷 弓 丿
绩	纟 龶 贝
绪	纟 耂 日
绫	纟 土 八 夊
续	纟 十 乛 大
绮	纟 大 丁 口
绯	纟 非
绰	纟 卜 早
绱	纟 尚
绲	纟 日 匕 匕
绳	纟 口 电
维	纟 隹
绵	纟 白 巾
绶	纟 爪 冖 又
绷	纟 月 月
绸	纟 ⺆ 土 口
绺	纟 夊 卜 口
绻	纟 丷 夫 㔾
综	纟 宀 示
绽	纟 宀 一 龰
绾	纟 宀 尸 コ
绿	纟 彐 水
缀	纟 又 又 又
缁	纟 巛 田
缂	纟 革
缃	纟 木 目
缄	纟 戊 一 口
缅	纟 面
缆	纟 〢 {⺮右} 见
缇	纟 日 一 龰
缈	纟 目 小 丿
缉	纟 口 耳
缋	纟 口 丄 贝
缌	纟 田 心
缍	纟 壬 龷
缎	纟 亻 三 殳
缏	纟 亻 一 乂
缑	纟 亻 コ 矢
缒	纟 𠂤 辶
缓	纟 爪 干 又
缔	纟 亠 丷 巾
缕	纟 米 女
编	纟 户 冊
缗	纟 巳 七 日
缘	纟 {互中} 豕
缙	纟 丌 䒑 日
缚	纟 甫 寸
缛	纟 辰 寸
缜	纟 十 且 八
缝	纟 夊 丰 辶
缟	纟 高
缠	纟 广 里
缡	纟 文 凵 厶
缢	纟 䒑 八 皿
缣	纟 䒑 彐 八
缤	纟 宀 斤 八
缥	纟 西 示
缦	纟 日 罒 又
缧	纟 田 糸
缨	纟 贝 贝 女
缩	纟 宀 亻 日
缪	纟 习 习 彡
缫	纟 巛 日 木
缬	纟 士 口 贝
缭	纟 大 丷 小
缮	纟 羊 䒑 口
缯	纟 丷 日 日
缰	纟 一 田 一
缱	纟 口 丄 辶
缲	纟 口 口 木
缳	纟 罒 一 𧘇
缴	纟 白 方 夊
缵	纟 ⺧ 儿 贝
缶	缶
缸	缶 工
缺	缶 コ 人
罂	贝 贝 缶
罄	士 {眉上} 殳 缶
罅	缶 {虎头} 丿 {于下}
罐	缶 艹 口 隹
网	冂 乂 乂
罔	冂 䒑 亡
罕	冖 八 干
罗	罒 夕
罘	罒 不
罚	罒 讠 刂
罟	罒 古
罡	罒 一 止
罢	罒 土 厶
罨	罒 大 电
罩	罒 卜 早
罪	罒 非
置	罒 十 且
罱	罒 十 冂 十
署	罒 耂 日
罴	罒 土 厶 灬
罹	罒 忄 隹
罾	罒 丷 日 日
羁	罒 革 马
羊	羊
羌	羊 乚
美	羊 大
羔	羊 灬
羚	羊 人 丶 マ
羝	羊 {卬左} 七 丶
羞	羊 丑
羟	羊 ス 工
羡	羊 二 欠
群	彐 丿 口 羊
羧	羊 厶 八 夊
羯	羊 日 勹 乚
羰	羊 山 {左上} 火
羲	羊 禾 丂 戈
羸	{贏頭} 羊
羹	羊 灬 羊 大
羼	尸 羊 羊 羊
羽	习 习
羿	习 习 卄
翁	八 厶 习 习
翅	十 又 习 习
翊	立 习 习
翌	习 习 立
翎	人 丶 マ 习
翔	羊 习 习
翕	合 习 习
翘	七 丿 兀 习
翟	习 习 隹
翠	习 习 亠 十
翡	非 习 习
翥	耂 日 习 习
翦	䒑 月 刂 习
翩	户 冊 习 习
翮	一 口 冂 习
翰	十 早 人 习
翱	白 大 十 习
翳	匚 矢 殳 习
翻	丿 米 田 习
翼	习 习 田 八
耀	小 兀 习 隹
老	耂 匕
考	耂 丂
耄	耂 匕 毛
者	耂 日
耆	耂 匕 日
耋	耂 匕 至
而	而
耍	而 女
耐	而 寸
耒	丰 八
耔	丰 八 子
耕	丰 八 二 {介下}
耖	丰 八 小 丿
耗	丰 八 毛
耘	丰 八 二 厶
耙	丰 八 巴
耜	丰 八 尸 コ
耠	丰 八 合
耢	丰 八 艹 力
耥	丰 八 尚
耦	丰 八 禺
耧	丰 八 米 女
耨	丰 八 辰 寸
耩	丰 八 {冓上} 土
耪	丰 八 亠 方
耱	丰 八 麻 石
耳	耳
耵	耳 丁
耶	耳 阝
耷	大 耳
耸	人 人 耳
耻	耳 止
耽	耳 冖 儿
耿	耳 火
聂	耳 又 又
聃	耳 冂 土
聆	耳 人 丶 マ
聊	耳 卯
聋	尤 丿 耳
职	耳 口 八
聍	耳 宀 丁
聒	耳 舌
联	耳 䒑 大
聘	耳 由 丂
聚	耳 又 亻 二
聩	耳 口 丄 贝
聪	耳 丷 口 心
聱	龶 勹 夊 耳
聿	彐 キ
肀	肀
肃	肀 {介下} 八
肄	匕 矢 彐 キ
肆	镸 彐 キ
肇	户 夊 彐 キ
肉	冂 人 人
肋	月 力
肌	月 几
肓	亡 月
肖	小 月
肘	月 寸
肚	月 土
肛	月 工
肜	月 彡
肝	月 干
肟	月 一 丂
肠	月 𠄎 {两撇}
股	月 殳
肢	月 十 又
肤	月 夫
肥	月 巴
肩	户 月
肪	月 方
肫	月 七 凵
肭	月 冂 人
肮	月 亠 几
肯	止 月
肱	月 {左上} 厶
育	亠 厶 月
肴	乂 {左上} 月
肷	月 欠
肺	月 一 巾
肼	月 二 {介下}
肽	月 大 丶
肾	〢 又 月
肿	月 口 丨
胀	月 长
胁	月 力 八
胂	月 申
胃	田 月
胄	由 月
胆	月 日 一
背	丬 匕 月
胍	月 瓜
胎	月 厶 口
胖	月 丷 キ
胗	月 人 彡
胙	月 𠂉 {乍下}
胚	月 不 一
胛	月 甲
胜	月 生
胝	月 {卬左} 七 丶
胞	月 勹 巳
胡	古 月
胤	儿 幺 月
胥	乛 龰 月
胧	月 尤 丿
胨	月 七 小
胩	月 上 卜
胪	月 卜 尸
胫	月 ス 工
胬	女 又 冂 人
胭	月 囗 大
胯	月 大 一 丂
胰	月 大 弓
胱	月 小 兀
胲	月 亥
胳	月 夊 口
胴	月 冂 一 口
胶	月 亠 八 乂
胸	月 勹 乂 凵
胺	月 宀 女
胼	月 䒑 卄
能	厶 月 匕 匕
脂	月 匕 日
脆	月 冖 厂 㔾
脉	月 丶 水
脊	二 二 人 月
脍	月 人 二 厶
脎	月 乂 木
脏	月 广 土
脐	月 文 {介下}
脑	月 文 凵
脒	月 米
脓	月 冖 𧘇
脔	亦 冂 人 人
脖	月 十 冖 子
脘	月 宀 一 兀
脚	月 土 厶 卩
脞	月 人 人 土
脬	月 爪 子
脯	月 甫
脱	月 丷 口 儿
脲	月 尸 水
脶	月 口 冂 人
脸	月 人 一 {兴上}
脾	月 {卑上} 十
腆	月 冂 龷 八
腈	月 龶 月
腊	月 龷 日
腋	月 亠 亻 乀
腌	月 大 电
腐	广 亻 寸 人
腑	月 广 亻 寸
腓	月 非
腔	月 穴 工
腕	月 宀 夕 㔾
腙	月 宀 示
腚	月 宀 一 龰
腠	月 𡗗 一 大
腥	月 日 生
腧	月 人 一 刂
腩	月 十 冂 十
腭	月 口 口 丂
腮	月 田 心
腰	月 西 女
腱	月 彐 キ 廴
腴	月 臼 人
腹	月 𠂉 日 夊
腺	月 白 水
腻	月 弋 二 贝
腼	月 面
腽	月 日 皿
腾	月 丷 夫 马
腿	月 艮 辶
膀	月 亠 丷 方
膂	方 𠂉 𧘇 月
膈	月 一 口 丨
膊	月 甫 寸
膏	高 月
膑	月 宀 斤 八
膘	月 西 示
膛	月 尚 土
膜	月 艹 日 大
膝	月 木 人 水
膣	月 穴 至
膦	月 米 夕 ヰ
膨	月 士 口 彡
膪	月 亠 丷 口
膳	月 羊 䒑 口
膺	广 亻 隹 月
膻	月 亠 囗 一
臀	尸 龷 八 月
臁	月 广 䒑 八
臂	尸 口 辛 月
臃	月 亠 {纟上} 隹
臆	月 立 日 心
臊	月 口 口 木
臌	月 士 口 又
臣	臣
臧	戈 爿 臣
自	自
臬	自 木
臭	自 犬
至	至
致	至 夊
臻	至 𡗗 禾
臼	臼
臾	臼 人
舀	爪 臼
舁	臼 卄
舂	𡗗 臼
舄	臼 勹 灬
舅	臼 田 力
舆	臼 车 一 八
舌	舌
舍	人 干 口
舐	舌 {卬左} 七
舒	人 干 口 予
舔	舌 一 大 丶
舛	夕 ヰ
舜	爪 冖 夕 ヰ
舞	𠂉 卅 一 ヰ
舟	舟
舡	舟 工
舢	舟 山
舣	舟 丶 乂
舨	舟 ⺁ 又
航	舟 亠 几
舫	舟 方
般	舟 殳
舭	舟 匕 匕
舯	舟 口 丨
舰	舟 见
舱	舟 人 㔾
舳	舟 由
舴	舟 𠂉 {乍下}
舵	舟 宀 匕
舶	舟 白
舷	舟 亠 幺
舸	舟 丁 口
船	舟 几 口
舻	舟 卜 尸
舾	舟 西
艄	舟 小 月
艇	舟 壬 廴
艉	舟 尸 毛
艋	舟 子 皿
艏	舟 䒑 自
艘	舟 臼 丨 又
艚	舟 艹 日 日
艟	舟 立 里
艨	舟 艹 冖 豕
艮	艮
良	丶 艮
艰	又 艮
色	冖 巴
艳	丰 冖 巴
艴	弓 {介下} 冖 巴
艹	艹
艺	艹 乙
艽	艹 九
艾	艹 乂
艿	艹 乃
节	艹 卩
芄	艹 九 丶
芈	卝 キ
芊	艹 千
芋	艹 一 {于下}
芍	艹 勹 丶
芎	艹 弓
芏	艹 土
芑	艹 己
芒	艹 亡
芗	艹 {纟上} 丿
芘	艹 匕 匕
芙	艹 夫
芜	艹 一 尢
芝	艹 之
芟	艹 殳
芡	艹 欠
芤	艹 子 乚
芥	艹 人 {介下}
芦	艹 户
芨	艹 乃 乀
芩	艹 人 丶 乛
芪	艹 {卬左} 七
芫	艹 一 兀
芬	艹 八 刀
芭	艹 巴
芮	艹 冂 人
芯	艹 心
芰	艹 十 又
花	艹 亻 匕
芳	艹 方
芴	艹 勹 {两撇}
芷	艹 止
芸	艹 二 厶
芹	艹 斤
芽	艹 牙
芾	艹 一 巾
苁	艹 人 人
苄	艹 亠 卜
苇	艹 キ 乛
苈	艹 厂 力
苊	艹 厂 㔾
苋	艹 见
苌	艹 长
苍	艹 人 㔾
苎	艹 宀 一
苏	艹 力 八
苑	艹 夕 㔾
苒	艹 冂 土
苓	艹 人 丶 マ
苔	艹 厶 口
苕	艹 刀 口
苗	艹 田
苘	艹 冂 口
苛	艹 丁 口
苜	艹 目
苞	艹 勹 巳
苟	艹 勹 口
苠	艹 巳 七
苡	艹 乚 丶 人
苣	艹 匚 コ
苤	艹 不 一
若	艹 {左上} 口
苦	艹 古
苫	艹 卜 口
苯	艹 木 一
英	艹 冂 大
苴	艹 且
苷	艹 卄 二
苹	艹 干 丷
苻	艹 亻 寸
茁	艹 屮 凵
茂	艹 戊
范	艹 氵 㔾
茄	艹 力 口
茅	艹 予 丿
茆	艹 卯
茇	艹 {左上} 又 丶
茈	艹 止 匕
茉	艹 末
茌	艹 亻 士
茎	艹 ス 工
茏	艹 尤 丿
茑	艹 鸟
茔	艹 冖 土
茕	艹 冖 乛 十
茗	艹 夕 口
茚	艹 {卬左} 一 卩
茛	艹 艮
茜	艹 西
茧	艹 虫
茨	艹 二 欠
茫	艹 氵 亡
茬	艹 {左上} 丨 土
茭	艹 亠 八 乂
茯	艹 亻 犬
茱	艹 牛 八
茳	艹 氵 工
茴	艹 囗 口
茵	艹 囗 大
茶	艹 人 木
茸	艹 耳
茹	艹 女 口
茺	艹 亠 厶 儿
茼	艹 冂 一 口
荀	艹 勹 日
荃	艹 人 王
荆	艹 一 卄 刂
荇	艹 彳 亍
草	艹 早
荏	艹 亻 壬
荐	艹 {左上} 丨 子
荑	艹 大 弓
荒	艹 亡 {荒下}
荔	艹 力 力 力
荚	艹 夫 丷
荛	艹 七 丿 兀
荜	艹 匕 匕 十
荞	艹 夭 {介下}
荟	艹 人 二 厶
荠	艹 文 {介下}
荡	艹 氵 𠄎 {两撇}
荣	艹 冖 木
荤	艹 冖 车
荥	艹 冖 水
荦	艹 冖 牛
荧	艹 冖 火
荨	艹 彐 寸
荩	艹 尸 乀 ⺀
荪	艹 子 小
荫	艹 阝 月
荬	艹 乛 ⺀ 大
荭	艹 纟 工
荮	艹 纟 寸
药	艹 纟 勹 丶
荷	艹 亻 丁 口
荸	艹 十 冖 子
荻	艹 犭 火
荼	艹 人 一 木
荽	艹 爪 女
莅	艹 亻 立
莆	艹 甫
莉	艹 禾 刂
莎	艹 氵 小 丿
莒	艹 口 口
莓	艹 𠂉 母
莘	艹 辛
莛	艹 壬 廴
莜	艹 亻 丨 夊
莞	艹 宀 一 兀
莠	艹 禾 乃
莨	艹 丶 艮
莩	艹 爪 子
莪	艹 丿 扌 戈
莫	艹 日 大
莰	艹 土 欠
莱	艹 一 米
莲	艹 车 辶
莳	艹 日 寸
莴	艹 口 冂 人
莶	艹 人 一 {兴上}
获	艹 犭 犬
莸	艹 犭 尤
莹	艹 冖 王 丶
莺	艹 冖 鸟
莼	艹 纟 七 凵
莽	艹 犬 卄
菀	艹 宀 夕 㔾
菁	艹 龶 月
菅	艹 宀 尸 コ
菇	艹 女 古
菊	艹 勹 米
菌	艹 囗 禾
菏	艹 氵 丁 口
菔	艹 月 卩 又
菖	艹 日 日
菘	艹 木 八 厶
菜	艹 爪 木
菝	艹 扌 {左上} 丶
菟	艹 冖 口 丶
菠	艹 氵 皮
菡	艹 乛 水 凵
菥	艹 木 斤
菩	艹 立 口
菪	艹 宀 石
菰	艹 子 瓜
菱	艹 土 八 夊
菲	艹 非
菸	艹 方 人 ⺀
菹	艹 氵 且
菽	艹 上 小 又
萁	艹 其
萃	艹 亠 人 十
萄	艹 勹 缶
萆	艹 {卑上} 十
萋	艹 十 彐 女
萌	艹 日 月
萍	艹 氵 干 丷
萎	艹 禾 女
萏	艹 冖 臼
萑	艹 隹
萘	艹 大 示
萜	艹 巾 卜 口
萝	艹 罒 夕
萤	艹 冖 虫
营	艹 冖 口 口
萦	艹 冖 糸
萧	艹 肀 {介下} 八
萨	艹 阝 立 丿
萱	艹 宀 一 一
萸	艹 臼 人
萼	艹 口 口 丂
落	艹 氵 夊 口
葆	艹 亻 口 木
葑	艹 土 土 寸
著	艹 耂 日
葙	艹 木 目
葚	艹 其 乚
葛	艹 日 勹 乚
葜	艹 丰 刀 大
葡	艹 勹 甫
董	艹 千 里
葩	艹 白 巴
葫	艹 古 月
葬	艹 一 夕 卄
葭	艹 尸 二 又
葱	艹 勹 {两撇} 心
葳	艹 戊 一 女
葵	艹 癶 一 大
葶	艹 {亮頭} 丁
葸	艹 田 心
葺	艹 口 耳
蒂	艹 亠 丷 巾
蒇	艹 戊 贝
蒈	艹 匕 匕 白
蒉	艹 口 丄 贝
蒋	艹 丬 夕 寸
蒌	艹 米 女
蒎	艹 氵 ⺁ 𧘇
蒗	艹 氵 丶 艮
蒙	艹 冖 一 豕
蒜	艹 示 示
蒡	艹 亠 丷 方
蒯	艹 月 月 刂
蒲	艹 氵 甫
蒴	艹 䒑 屮 月
蒸	艹 乛 水 灬
蒹	艹 䒑 彐 八
蒺	艹 疒 矢
蒽	艹 囗 大 心
蒿	艹 高
蓁	艹 𡗗 禾
蓄	艹 亠 幺 田
蓉	艹 穴 人 口
蓊	艹 八 厶 习
蓍	艹 耂 匕 日
蓐	艹 辰 寸
蓑	艹 {京頭} 一 𧘇
蓓	艹 亻 立 口
蓖	艹 {囟框} 乂 匕
蓝	艹 〢 {⺮右} 皿
蓟	艹 鱼 刂
蓠	艹 文 凵 厶
蓣	艹 予 丆 贝
蓥	艹 冖 金
蓦	艹 日 大 马
蓬	艹 夊 丰 辶
蓰	艹 彳 止 龰
蓼	艹 习 习 彡
蓿	艹 宀 亻 日
蔌	艹 木 口 欠
蔑	艹 罒 戊 丶
蔓	艹 日 罒 又
蔗	艹 广 卄 灬
蔚	艹 尸 示 寸
蔟	艹 方 𠂉 矢
蔡	艹 {祭上} 示
蔫	艹 一 止 灬
蔬	艹 乛 止 {荒下}
蔷	艹 十 䒑 口
蔸	艹 白 {卬左} 儿
蔹	艹 人 一 夊
蔺	艹 门 隹
蔻	艹 宀 一 又
蔼	艹 讠 日 乚
蔽	艹 丷 巾 夊
蕃	艹 丿 米 田
蕈	艹 西 早
蕉	艹 隹 灬
蕊	艹 心 心 心
蕖	艹 氵 匚 木
蕙	艹 {專上} 心
蕞	艹 日 耳 又
蕤	艹 豕 生
蕨	艹 厂 䒑 欠
蕲	艹 丷 日 斤
蕴	艹 纟 日 皿
蕹	艹 亠 {纟上} 隹
蕺	艹 口 耳 戈
蕻	艹 镸 龷 八
蕾	艹 雨 田
薄	艹 氵 甫 寸
薅	艹 女 辰 寸
薇	艹 {微上} 一 几
薏	艹 立 日 心
薛	艹 𠂤 辛
薜	艹 尸 口 辛
薤	艹 一 夕 一
薨	艹 罒 冖 匕
薪	艹 立 木 斤
薮	艹 米 女 夊
薯	艹 罒 耂 日
薰	艹 千 黑
薷	艹 雨 而
薹	艹 士 口 至
藁	艹 高 木
藉	艹 丰 八 日
藏	艹 戈 爿 臣
藐	艹 豸 白 儿
藓	艹 鱼 羊
藕	艹 丰 八 禺
藜	艹 禾 勹 水
藤	艹 月 丷 水
藩	艹 氵 丿 田
藻	艹 氵 口 木
藿	艹 雨 隹
蘅	艹 彳 鱼 亍
蘑	艹 麻 石
蘖	艹 𠂤 辛 木
蘧	艹 {虎头} 豕 辶
蘩	艹 𠂉 母 糸
蘸	艹 酉 隹 灬
蘼	艹 麻 非
虍	{虎头}
虎	虎
虏	{虎头} 力
虐	{虎头} {反彐}
虑	{虎头} 心
虔	{虎头} 文
虚	{虎头} 业
虞	{虎头} 口 一 大
虢	爪 寸 虎
虫	虫
虬	虫 乚
虮	虫 几
虱	乛 丿 虫
虹	虫 工
虺	兀 虫
虻	虫 亡
虼	虫 𠂉 乙
虽	口 虫
虾	虫 下
虿	一 勹 虫
蚀	饣 虫
蚁	虫 丶 乂
蚂	虫 马
蚊	虫 文
蚋	虫 冂 人
蚌	虫 丰
蚍	虫 匕 匕
蚓	虫 弓 丨
蚕	一 大 虫
蚜	虫 牙
蚝	虫 毛
蚣	虫 八 厶
蚤	又 丶 虫
蚧	虫 人 {介下}
蚨	虫 夫
蚩	屮 一 虫
蚪	虫 ⺀ 十
蚬	虫 见
蚯	虫 斤 一
蚰	虫 由
蚱	虫 𠂉 {乍下}
蚴	虫 幺 力
蚵	虫 丁 口
蚶	虫 卄 二
蚺	虫 冂 土
蛀	虫 丶 王
蛄	虫 古
蛆	虫 且
蛇	虫 宀 匕
蛉	虫 人 丶 マ
蛊	虫 皿
蛋	乛 龰 虫
蛎	虫 厂 一 勹
蛏	虫 又 土
蛐	虫 冂 龷
蛑	虫 厶 牛
蛔	虫 囗 口
蛘	虫 羊
蛙	虫 土 土
蛛	虫 牛 八
蛞	虫 舌
蛟	虫 亠 八 乂
蛤	虫 合
蛩	工 几 丶 虫
蛭	虫 至
蛮	亦 虫
蛰	扌 九 丶 虫
蛱	虫 夫 丷
蛲	虫 七 丿 兀
蛳	虫 リ 一 巾
蛴	虫 文 {介下}
蛸	虫 小 月
蛹	虫 マ 用
蛾	虫 丿 扌 戈
蜀	罒 勹 虫
蜂	虫 夊 丰
蜃	辰 虫
蜇	扌 斤 虫
蜈	虫 口 一 大
蜉	虫 爪 子
蜊	虫 禾 刂
蜍	虫 人 一 木
蜒	虫 丿 止 廴
蜓	虫 壬 廴
蜕	虫 丷 口 儿
蜗	虫 口 冂 人
蜘	虫 矢 口
蜚	非 虫
蜜	宀 心 丿 虫
蜞	虫 其
蜡	虫 龷 日
蜢	虫 子 皿
蜣	虫 羊 乚
蜥	虫 木 斤
蜩	虫 ⺆ 土 口
蜮	虫 戈 口 一
蜱	虫 {卑上} 十
蜴	虫 日 勹 {两撇}
蜷	虫 丷 夫 㔾
蜻	虫 龶 月
蜾	虫 日 木
蜿	虫 宀 夕 㔾
蝇	虫 口 电
蝈	虫 囗 王 丶
蝉	虫 丷 日 十
蝌	虫 禾 ⺀ 十
蝎	虫 日 勹 乚
蝓	虫 人 一 刂
蝗	虫 白 王
蝙	虫 户 冊
蝠	虫 一 口 田
蝣	虫 方 𠂉 子
蝤	虫 丷 酉
蝥	予 丿 夊 虫
蝮	虫 𠂉 日 夊
蝰	虫 大 土 土
蝴	虫 古 月
蝶	虫 世 木
蝻	虫 十 冂 十
蝼	虫 米 女
蝽	虫 𡗗 日
蝾	虫 艹 冖 木
螂	虫 丶 彐 阝
螃	虫 亠 丷 方
螅	虫 自 心
螈	虫 厂 白 小
螋	虫 臼 丨 又
融	一 口 冂 虫
螓	虫 𡗗 禾
螗	虫 广 肀 口
螟	虫 冖 日 八
螨	虫 艹 一 人
螫	土 {介下} 八 虫
螬	虫 艹 日 日
螭	虫 文 凵 厶
螯	龶 勹 夊 虫
螳	虫 尚 土
螵	虫 西 示
螺	虫 田 糸
螽	夊 ⺀ 虫 虫
蟀	虫 亠 幺 十
蟆	虫 艹 日 大
蟊	予 丿 虫 虫
蟋	虫 丿 米 心
蟑	虫 立 早
蟒	虫 艹 犬 卄
蟓	虫 冖 口 豕
蟛	虫 士 口 彡
蟠	虫 丿 米 田
蟥	虫 龷 由 八
蟪	虫 {專上} 心
蟮	虫 羊 䒑 口
蟹	冖 用 刀 虫
蟾	虫 冖 厂 言
蠃	{贏頭} 虫
蠊	虫 广 䒑 八
蠓	虫 艹 冖 豕
蠕	虫 雨 而
蠖	虫 艹 隹 又
蠛	虫 艹 罒 丶
蠡	{互中} 豕 虫 虫
蠢	𡗗 日 虫 虫
蠲	䒑 八 皿 虫
蠹	十 口 冖 虫
蠼	虫 目 目 又
血	丿 皿
衄	丿 皿 丑
衅	丿 皿 丷 キ
行	彳 亍
衍	彳 氵 亍
衔	彳 钅 亍
街	彳 土 土 亍
衙	彳 一 {五下} 亍
衡	彳 鱼 人 亍
衢	彳 目 目 亍
衣	亠 𧘇
衤	衤
补	衤 卜
表	龶 𧘇
衩	衤 又 丶
衫	衤 彡
衬	衤 寸
衮	亠 八 厶 𧘇
衰	{京頭} 一 𧘇
衲	衤 冂 人
衷	{京頭} 丨 𧘇
衽	衤 壬
衾	人 丶 乛 𧘇
衿	衤 人 丶 乛
袁	土 口 𧘇
袂	衤 コ 人
袄	衤 夭
袅	{鸟上} 亠 𧘇
袈	力 口 亠 𧘇
袋	亻 弋 亠 𧘇
袍	衤 勹 巳
袒	衤 日 一
袖	衤 由
袜	衤 末
袢	衤 丷 キ
袤	亠 予 丿 𧘇
被	衤 皮
袭	尤 丿 亠 𧘇
袱	衤 亻 犬
袷	衤 合
袼	衤 夊 口
裁	十 戈 亠 𧘇
裂	一 夕 刂 𧘇
装	丬 士 亠 𧘇
裆	衤 小 彐
裉	衤 艮
裎	衤 口 王
裒	亠 臼 𧘇
裔	亠 𧘇 冂 口
裕	衤 八 人 口
裘	一 水 丶 𧘇
裙	衤 彐 丿 口
裟	氵 小 丿 𧘇
裢	衤 车 辶
裣	衤 人 一 {兴上}
裤	衤 广 车
裥	衤 门 日
裨	衤 {卑上} 十
裰	衤 又 又 又
裱	衤 龶 𧘇
裳	尚 亠 𧘇
裴	非 亠 𧘇
裸	衤 日 木
裹	亠 日 木 𧘇
裼	衤 日 勹 {两撇}
裾	衤 尸 古
褂	衤 土 土 卜
褊	衤 户 冊
褐	衤 日 勹 乚
褒	亠 亻 口 𧘇
褓	衤 亻 口 木
褙	衤 丬 匕 月
褚	衤 耂 日
褛	衤 米 女
褡	衤 艹 合
褥	衤 辰 寸
褪	衤 艮 辶
褫	衤 ⺁ 虎
褰	宀 {冓上} 八 𧘇
褴	衤 〢 {⺮右} 皿
褶	衤 习 习 白
襁	衤 弓 口 虫
襄	{京頭} 口 {冓上} 𧘇
襞	尸 口 辛 𧘇
襟	衤 木 木 示
襦	衤 雨 而
襻	衤 木 乂 手
西	西
要	西 女
覃	西 早
覆	西 彳 𠂉 夊
见	见
观	又 见
规	夫 见
觅	爪 见
视	示 见
觇	卜 口 见
览	〢 {⺮右} 见
觉	⺍ 冖 见
觊	山 己 见
觋	工 人 人 见
觌	十 乛 ⺀ 见
觎	人 一 月 见
觏	{冓上} 冂 土 见
觐	革 二 见
觑	{虎头} 业 见
角	冖 用
觖	冖 用 コ 人
觚	冖 用 瓜
觜	止 匕 冖 用
觞	冖 用 𠂉 {两撇}
解	冖 用 刀 牛
觥	冖 用 小 兀
触	冖 用 虫
觫	冖 用 木 口
觯	冖 用 丷 十
觳	{穀頭} 一 冖 用
言	言
訇	勹 言
訾	止 匕 言
詈	罒 言
詹	冖 厂 八 言
誉	{兴上} 八 言
誊	丷 夫 言
誓	扌 斤 言
謇	宀 {冓上} 八 言
謦	士 {眉上} 殳 言
警	艹 勹 口 言
譬	尸 口 辛 言
讠	讠
计	讠 十
订	讠 丁
讣	讠 卜
认	讠 人
讥	讠 几
讦	讠 干
讧	讠 工
讨	讠 寸
让	讠 上
讪	讠 山
讫	讠 𠂉 乙
训	讠 川
议	讠 丶 乂
讯	讠 乛 十
记	讠 己
讲	讠 二 {介下}
讳	讠 キ 乛
讴	讠 匚 乂
讵	讠 匚 コ
讶	讠 牙
讷	讠 冂 人
许	讠 𠂉 十
讹	讠 亻 匕
论	讠 人 匕
讼	讠 八 厶
讽	讠 几 乂
设	讠 殳
访	讠 方
诀	讠 コ 人
证	讠 一 止
诂	讠 古
诃	讠 丁 口
评	讠 干 丷
诅	讠 且
识	讠 口 八
诈	讠 𠂉 {乍下}
诉	讠 斤 丶
诊	讠 人 彡
诋	讠 {卬左} 七 丶
诌	讠 冖 彐
词	讠 乛 一 口
诎	讠 屮 凵
诏	讠 刀 口
译	讠 又 キ
诒	讠 厶 口
诓	讠 匚 王
诔	讠 丰 八
试	讠 弋 工
诖	讠 土 土
诗	讠 土 寸
诘	讠 士 口
诙	讠 {左上} 火
诚	讠 戊 乛
诛	讠 牛 八
诜	讠 ⺧ 儿
话	讠 舌
诞	讠 丿 止 廴
诟	讠 ⺁ 一 口
诠	讠 人 王
诡	讠 冖 厂 㔾
询	讠 勹 日
诣	讠 匕 日
诤	讠 冖 彐 亅
该	讠 亥
详	讠 羊
诧	讠 宀 丿 七
诨	讠 冖 车
诩	讠 习 习
诫	讠 戈 卄
诬	讠 工 人 人
语	讠 一 {五下} 口
诮	讠 小 月
误	讠 口 一 大
诰	讠 ⺧ 口
诱	讠 禾 乃
诲	讠 𠂉 母
诳	讠 犭 王
说	讠 丷 口 儿
诵	讠 マ 用
诶	讠 厶 矢
请	讠 龶 月
诸	讠 耂 日
诹	讠 耳 又
诺	讠 艹 {左上} 口
读	讠 十 乛 大
诼	讠 豕 丶
诽	讠 非
课	讠 日 木
诿	讠 禾 女
谀	讠 臼 人
谁	讠 隹
谂	讠 人 丶 心
调	讠 ⺆ 土 口
谄	讠 冖 臼
谅	讠 {京頭} 小
谆	讠 {京頭} 子
谇	讠 亠 人 十
谈	讠 火 火
谊	讠 宀 且
谋	讠 卄 二 木
谌	讠 其 乚
谍	讠 世 木
谎	讠 艹 亡 {荒下}
谏	讠 木 囗 丷
谐	讠 匕 匕 白
谑	讠 {虎头} {反彐}
谒	讠 日 勹 乚
谓	讠 田 月
谔	讠 口 口 丂
谕	讠 人 一 刂
谖	讠 爪 干 又
谗	讠 冖 口 ⺀
谘	讠 二 欠 口
谙	讠 立 日
谚	讠 立 丿 彡
谛	讠 亠 丷 巾
谜	讠 米 辶
谝	讠 户 冊
谟	讠 艹 日 大
谠	讠 尚 儿
谡	讠 田 八 夊
谢	讠 身 寸
谣	讠 爪 缶
谤	讠 亠 丷 方
谥	讠 䒑 八 皿
谦	讠 䒑 彐 八
谧	讠 心 丿 皿
谨	讠 革 二
谩	讠 日 罒 又
谪	讠 亠 丷 古
谫	讠 䒑 月 刀
谬	讠 习 习 彡
谭	讠 西 早
谮	讠 匚 儿 日
谯	讠 隹 灬
谰	讠 门 木 丷
谱	讠 䒑 业 日
谲	讠 予 丿 口
谳	讠 十 冂 犬
谴	讠 口 丄 辶
谵	讠 冖 厂 言
谶	讠 人 人 一
谷	八 人 口
豁	宀 丰 口 口
豆	一 口 䒑
豇	一 口 䒑 工
豉	一 口 䒑 又
豌	一 口 䒑 㔾
豕	豕
豚	月 豕
象	冖 口 豕
豢	丷 夫 豕
豪	{亮頭} 豕
豫	予 冖 口 豕
豳	山 豕 豕
豸	豸
豹	豸 勹 丶
豺	豸 {于下} 丿
貂	豸 刀 口
貅	豸 亻 木
貉	豸 夊 口
貊	豸 丆 日
貌	豸 白 儿
貔	豸 {囟框} 乂 匕
貘	豸 艹 日 大
贝	贝
贞	卜 贝
负	冖 贝
贡	工 贝
财	贝 {于下} 丿
责	龶 贝
贤	〢 又 贝
败	贝 夊
账	贝 长
货	亻 匕 贝
质	⺁ 十 贝
贩	贝 ⺁ 又
贪	人 丶 乛 贝
贫	八 刀 贝
贬	贝 丿 之
购	贝 勹 厶
贮	贝 宀 一
贯	{母框} 十 贝
贰	弋 二 贝
贱	贝 一 戈
贲	十 卄 贝
贳	世 贝
贴	贝 卜 口
贵	口 丄 贝
贶	贝 口 儿
贷	亻 弋 贝
贸	卯 贝
费	弓 {介下} 贝
贺	力 口 贝
贻	贝 厶 口
贼	贝 戈 {左上}
贽	扌 九 丶 贝
贾	西 贝
贿	贝 {左上} 月
赀	止 匕 贝
赁	亻 壬 贝
赂	贝 夊 口
赃	贝 广 土
资	二 欠 贝
赅	贝 亥
赆	贝 尸 乀 ⺀
赇	贝 一 水 丶
赈	贝 辰
赉	一 米 贝
赊	贝 人 示
赋	贝 一 弋 止
赌	贝 耂 日
赍	十 人 人 贝
赎	贝 十 乛 大
赏	尚 贝
赐	贝 日 勹 {两撇}
赓	广 彐 人 贝
赔	贝 立 口
赕	贝 火 火
赖	木 口 冖 贝
赘	龶 勹 夊 贝
赙	贝 甫 寸
赚	贝 䒑 彐 八
赛	宀 {冓上} 八 贝
赜	臣 龶 贝
赝	厂 亻 隹 贝
赞	⺧ 儿 ⺧ 贝
赠	贝 丷 日 日
赡	贝 冖 厂 言
赢	{贏頭} 贝
赣	立 早 夊 贝
赤	土 {介下} 八
赦	土 {介下} 八 夊
赧	土 {介下} 八 又
赫	土 {介下} 八 八
赭	土 {介下} 八 日
走	走
赳	走 丩
赴	走 卜
赵	走 乂
赶	走 干
起	走 己
趁	走 人 彡
趄	走 且
超	走 刀 口
越	走 戈 乚
趋	走 冖 彐
趑	走 二 欠
趔	走 一 夕 刂
趟	走 尚
趣	走 耳 又
趱	走 ⺧ 儿 贝
足	足
趴	足 八
趵	足 勹 丶
趸	一 勹 足
趺	足 夫
趼	足 一 卄
趾	足 止
趿	足 乃 乀
跃	足 夭
跄	足 人 㔾
跆	足 厶 口
跋	足 {左上} 又 丶
跌	足 丿 夫
跎	足 宀 匕
跏	足 力 口
跑	足 勹 巳
跖	足 石
跗	足 亻 寸
跚	足 ⺆ ⺆ 一
跛	足 皮
距	足 匚 コ
跞	足 {乐上} 小
跟	足 艮
跣	足 ⺧ 儿
跤	足 亠 八 乂
跨	足 大 一 丂
跪	足 冖 厂 㔾
跫	工 几 丶 足
跬	足 土 土
路	足 夊 口
跳	足 儿 二 二
践	足 一 戈
跷	足 七 丿 兀
跸	足 匕 匕 十
跹	足 千 辶
跺	足 几 木
跻	足 文 {介下}
跽	足 己 心
踅	扌 斤 足
踉	足 丶 艮
踊	足 マ 用
踌	足 丰 寸
踏	足 水 日
踔	足 卜 早
踝	足 日 木
踞	足 尸 古
踟	足 矢 口
踢	足 日 勹 {两撇}
踣	足 立 口
踩	足 爪 木
踪	足 宀 示
踬	足 ⺁ 十 贝
踮	足 广 卜 口
踯	足 䒑 大 阝
踱	足 广 卄 又
踵	足 千 里
踹	足 山 而
踺	足 彐 キ 廴
踽	足 丿 虫 冂
蹀	足 世 木
蹁	足 户 冊
蹂	足 予 丿 木
蹄	足 亠 丷 巾
蹇	宀 {冓上} 八 足
蹈	足 爪 臼
蹉	足 羊 工
蹊	足 爪 幺 大
蹋	足 日 习 习
蹑	足 耳 又 又
蹒	足 艹 一 人
蹙	戊 上 小 足
蹦	足 山 月 月
蹩	丷 巾 八 足
蹬	足 癶 一 䒑
蹭	足 丷 日 日
蹯	足 丿 米 田
蹰	足 厂 一 寸
蹲	足 丷 酉 寸
蹴	足 {京頭} 小 尤
蹶	足 厂 䒑 欠
蹼	足 业 䒑 夫
蹿	足 穴 口 丨
躁	足 口 口 木
躅	足 罒 勹 虫
躇	足 艹 耂 日
躏	足 艹 门 隹
躐	足 巛 囗 {鼠下}
躔	足 广 里 土
躜	足 ⺧ 儿 贝
躞	足 言 火 又
身	身
躬	身 弓
躯	身 匚 乂
躲	身 几 木
躺	身 尚
軎	車 口
车	车
轧	车 乚
轨	车 九
轩	车 干
轫	车 刀 丶
转	车 二 ㇉ 丶
轭	车 厂 㔾
轮	车 人 匕
软	车 欠
轰	车 又 又
轱	车 古
轲	车 丁 口
轳	车 卜 尸
轴	车 由
轵	车 口 八
轶	车 丿 夫
轷	车 丿 丷 {于下}
轸	车 人 彡
轹	车 {乐上} 小
轺	车 刀 口
轻	车 ス 工
轼	车 弋 工
载	十 戈 车
轾	车 至
轿	车 夭 {介下}
辁	车 人 王
辂	车 夊 口
较	车 亠 八 乂
辄	车 耳 乚
辅	车 甫
辆	车 一 冂 人
辇	夫 夫 车
辈	非 车
辉	小 兀 冖 车
辊	车 日 匕 匕
辋	车 冂 䒑 亡
辍	车 又 又 又
辎	车 巛 田
辏	车 𡗗 一 大
辐	车 一 口 田
辑	车 口 耳
输	车 人 一 刂
辔	纟 车 纟 口
辕	车 土 口 𧘇
辖	车 宀 丰 口
辗	车 尸 艹 {畏下}
辘	车 鹿
辙	车 亠 厶 夊
辚	车 米 夕 ヰ
辛	辛
辜	古 辛
辞	舌 辛
辟	尸 口 辛
辣	辛 木 口
辨	辛 リ 辛
辩	辛 讠 辛
辫	辛 纟 辛
辰	辰
辱	辰 寸
辶	辶
边	力 辶
辽	了 辶
达	大 辶
迁	千 辶
迂	一 {于下} 辶
迄	𠂉 乙 辶
迅	乛 十 辶
过	寸 辶
迈	一 勹 辶
迎	{卬左} 卩 辶
运	二 厶 辶
近	斤 辶
迓	牙 辶
返	⺁ 又 辶
迕	𠂉 十 辶
还	不 辶
这	文 辶
进	二 {介下} 辶
远	一 兀 辶
违	キ 乛 辶
连	车 辶
迟	尸 乀 辶
迢	刀 口 辶
迤	𠂉 也 辶
迥	冂 口 辶
迦	力 口 辶
迨	厶 口 辶
迩	冖 小 辶
迪	由 辶
迫	白 辶
迭	丿 夫 辶
迮	𠂉 {乍下} 辶
述	木 丶 辶
迳	ス 工 辶
迷	米 辶
迸	䒑 卄 辶
迹	亦 辶
追	𠂤 辶
退	艮 辶
送	䒑 大 辶
适	舌 辶
逃	儿 二 二 辶
逄	夊 ヰ 辶
逅	⺁ 一 口 辶
逆	䒑 屮 辶
选	⺧ 儿 辶
逊	子 小 辶
逋	甫 辶
逍	小 月 辶
透	禾 乃 辶
逐	豕 辶
逑	一 水 丶 辶
递	丷 弓 丨 辶
途	人 一 木 辶
逖	犭 火 辶
逗	一 口 䒑 辶
通	マ 用 辶
逛	犭 王 辶
逝	扌 斤 辶
逞	口 王 辶
速	木 口 辶
造	⺧ 口 辶
逡	厶 八 夊 辶
逢	夊 丰 辶
逦	一 {冂丶} {冂丶} 辶
逭	宀 尸 コ 辶
逮	彐 水 辶
逯	彐 水 辶
逵	土 八 土 辶
逶	禾 女 辶
逸	冖 口 儿 辶
逻	罒 夕 辶
逼	一 口 田 辶
逾	人 一 月 辶
遁	⺁ 十 目 辶
遂	䒑 豕 辶
遄	山 而 辶
遇	禺 辶
遍	户 冊 辶
遏	日 勹 人 辶
遐	尸 二 コ 辶
遑	白 王 辶
遒	丷 酉 辶
道	䒑 自 辶
遗	口 丄 贝 辶
遘	{冓上} 冂 土 辶
遛	卯 田 辶
遢	日 习 习 辶
遣	口 丄 尸 辶
遥	爪 缶 辶
遨	龶 勹 夊 辶
遭	艹 日 日 辶
遮	广 卄 一 辶
遴	米 夕 ヰ 辶
遵	丷 酉 寸 辶
遽	{虎头} 豕 辶
避	尸 口 辛 辶
邀	白 方 夊 辶
邂	冖 用 刀 辶
邃	穴 䒑 豕 辶
邈	豸 白 儿 辶
邋	巛 囗 乂 辶
邑	口 巴
邓	又 阝
邕	巛 口 巴
邗	干 阝
邙	亡 阝
邛	工 阝
邝	广 阝
邡	方 阝
邢	一 卄 阝
那	乛 キ 阝
邦	丰 阝
邪	牙 阝
邬	乌 阝
邮	由 阝
邯	卄 二 阝
邰	厶 口 阝
邱	斤 一 阝
邳	不 一 阝
邴	一 冂 人 阝
邵	刀 口 阝
邶	丬 匕 阝
邸	{卬左} 七 丶 阝
邹	冖 彐 阝
邺	业 阝
邻	人 丶 マ 阝
邾	牛 八 阝
郁	{左上} 月 阝
郄	乂 {左上} 厶 阝
郅	至 阝
郇	勹 日 阝
郊	亠 八 乂 阝
郎	丶 彐 厶 阝
郏	夫 丷 阝
郐	人 二 厶 阝
郑	䒑 大 阝
郓	冖 车 阝
郗	乂 {左上} 巾 阝
郛	爪 子 阝
郜	⺧ 口 阝
郝	土 {介下} 八 阝
郡	彐 丿 口 阝
郢	口 王 阝
郦	一 {冂丶} {冂丶} 阝
郧	口 贝 阝
部	立 口 阝
郫	{卑上} 十 阝
郭	{京頭} 子 阝
郯	火 火 阝
郴	木 木 阝
郸	丷 日 十 阝
都	耂 日 阝
郾	匚 日 女 阝
鄂	口 口 一 阝
鄄	西 土 阝
鄙	口 十 囗 阝
鄞	革 二 阝
鄢	一 止 丂 阝
鄣	立 早 阝
鄯	羊 䒑 口 阝
鄱	丿 米 田 阝
鄹	耳 又 亻 阝
酃	雨 口 口 阝
酆	山 丰 丰 阝
酉	酉
酊	酉 丁
酋	丷 酉
酌	酉 勹 丶
配	酉 己
酎	酉 寸
酏	酉 也
酐	酉 干
酒	氵 酉
酗	酉 乂 凵
酚	酉 八 刀
酝	酉 二 厶
酞	酉 大 丶
酡	酉 宀 匕
酢	酉 𠂉 {乍下}
酣	酉 卄 二
酤	酉 古
酥	酉 禾
酩	酉 夕 口
酪	酉 夊 口
酬	酉 ⺍ 川
酮	酉 冂 一 口
酯	酉 匕 日
酰	酉 ⺧ 儿
酱	丬 夕 酉
酲	酉 口 王
酴	酉 人 一 木
酵	酉 耂 子
酶	酉 𠂉 母
酷	酉 ⺧ 口
酸	酉 厶 八 夊
酹	酉 爪 寸
酽	酉 丌 䒑 丿
酾	酉 一 {冂丶} {冂丶}
酿	酉 丶 艮
醅	酉 立 口
醇	酉 {京頭} 子
醉	酉 亠 人 十
醋	酉 龷 日
醌	酉 日 匕 匕
醍	酉 日 一 龰
醐	酉 古 月
醑	酉 乛 龰 月
醒	酉 日 生
醚	酉 米 辶
醛	酉 艹 人 王
醢	酉 {左上} 口 皿
醣	酉 广 肀 口
醪	酉 习 习 彡
醭	酉 业 䒑 夫
醮	酉 隹 灬
醯	酉 亠 厶 皿
醴	酉 冂 龷 䒑
醵	酉 {虎头} 豕
醺	酉 千 黑
采	爪 木
釉	丿 米 由
释	丿 米 又 キ
里	里
重	千 里
野	里 予
量	日 一 里
金	金
釜	八 乂 干 䒑
鉴	〢 {⺮右} 金
銎	工 几 丶 金
銮	亦 金
鋈	氵 夭 金
錾	车 斤 金
鍪	予 丿 夊 金
鍾	金 千 里
鎏	氵 亠 厶 金
鏊	龶 勹 夊 金
鏖	鹿 金
鐾	尸 口 辛 金
鑫	金 金 金
钅	钅
钆	钅 乚
钇	钅 乙
针	钅 十
钉	钅 丁
钊	钅 刂
钋	钅 卜
钌	钅 了
钍	钅 土
钎	钅 千
钏	钅 川
钐	钅 彡
钒	钅 几 丶
钓	钅 勹 丶
钔	钅 门
钕	钅 女
钗	钅 又 丶
钙	钅 丅 一 ㇉
钚	钅 不
钛	钅 大 丶
钜	钅 匚 コ
钝	钅 七 凵
钞	钅 小 丿
钟	钅 口 丨
钠	钅 冂 人
钡	钅 贝
钢	钅 冂 乂
钣	钅 ⺁ 又
钤	钅 人 丶 乛
钥	钅 月
钦	钅 欠
钧	钅 勹 二
钨	钅 乌
钩	钅 勹 厶
钪	钅 亠 几
钫	钅 方
钬	钅 火
钭	钅 ⺀ 十
钮	钅 丑
钯	钅 巴
钰	钅 王 丶
钱	钅 一 戈
钲	钅 一 止
钳	钅 卄 二
钴	钅 古
钵	钅 木 一
钶	钅 丁 口
钷	钅 匚 口
钸	钅 {左上} 巾
钹	钅 {左上} 又 丶
钺	钅 戈 乚
钻	钅 卜 口
钼	钅 目
钽	钅 日 一
钾	钅 甲
钿	钅 田
铀	钅 由
铁	钅 丿 夫
铂	钅 白
铃	钅 人 丶 マ
铄	钅 {乐上} 小
铅	钅 几 口
铆	钅 卯
铈	钅 亠 巾
铉	钅 亠 幺
铊	钅 宀 匕
铋	钅 心 丿
铌	钅 尸 匕
铍	钅 皮
铎	钅 又 キ
铐	钅 耂 丂
铑	钅 耂 匕
铒	钅 耳
铕	钅 {左上} 月
铖	钅 戊 乛
铗	钅 夫 丷
铘	钅 牙 阝
铙	钅 七 丿 兀
铛	钅 小 彐
铜	钅 冂 一 口
铝	钅 口 口
铞	钅 口 巾
铟	钅 囗 大
铠	钅 山 己
铡	钅 贝 刂
铢	钅 牛 八
铣	钅 ⺧ 儿
铤	钅 壬 廴
铥	钅 壬 厶
铧	钅 亻 匕 十
铨	钅 人 王
铩	钅 乂 木
铪	钅 合
铫	钅 儿 二 二
铬	钅 夊 口
铭	钅 夕 口
铮	钅 冖 彐 亅
铯	钅 冖 巴
铰	钅 亠 八 乂
铱	钅 亠 𧘇
铲	钅 立 丿
铳	钅 亠 厶 儿
铴	钅 氵 𠄎 {两撇}
铵	钅 宀 女
银	钅 艮
铷	钅 女 口
铸	钅 丰 寸
铹	钅 艹 冖 力
铺	钅 甫
铼	钅 一 米
铽	钅 弋 心
链	钅 车 辶
铿	钅 〢 又 土
销	钅 小 月
锁	钅 小 贝
锂	钅 里
锃	钅 口 王
锄	钅 且 力
锅	钅 口 冂 人
锆	钅 ⺧ 口
锇	钅 丿 扌 戈
锈	钅 禾 乃
锉	钅 人 人 土
锊	钅 爪 寸
锋	钅 夊 丰
锌	钅 辛
锍	钅 亠 厶 {荒下}
锎	钅 门 一 卄
锏	钅 门 日
锐	钅 丷 口 儿
锑	钅 丷 弓 丿
锒	钅 丶 艮
锓	钅 彐 冖 又
锔	钅 尸 乛 口
锕	钅 阝 丁 口
锖	钅 龶 月
锗	钅 耂 日
锘	钅 艹 {左上} 口
错	钅 龷 日
锚	钅 艹 田
锛	钅 大 十 卄
锝	钅 日 一 寸
锞	钅 日 木
锟	钅 日 匕 匕
锡	钅 日 勹 {两撇}
锢	钅 囗 古
锣	钅 罒 夕
锤	钅 壬 龷
锥	钅 隹
锦	钅 白 巾
锨	钅 斤 欠
锩	钅 丷 夫 㔾
锪	钅 勹 {两撇} 心
锫	钅 立 口
锬	钅 火 火
锭	钅 宀 一 龰
键	钅 彐 キ 廴
锯	钅 尸 古
锰	钅 子 皿
锱	钅 巛 田
锲	钅 丰 刀 大
锴	钅 匕 匕 白
锵	钅 丬 夕 寸
锶	钅 田 心
锷	钅 口 口 丂
锸	钅 千 臼
锹	钅 禾 火
锺	钅 千 里
锻	钅 亻 三 殳
锼	钅 臼 丨 又
锾	钅 爪 干 又
锿	钅 {京頭} 𧘇
镀	钅 广 卄 又
镁	钅 羊 大
镂	钅 米 女
镄	钅 弓 {介下} 贝
镅	钅 {眉上} 目
镆	钅 艹 日 大
镇	钅 十 且 八
镉	钅 一 口 丨
镊	钅 耳 又 又
镌	钅 隹 乃
镍	钅 自 木
镎	钅 合 手
镏	钅 卯 田
镐	钅 高
镑	钅 亠 丷 方
镒	钅 䒑 八 皿
镓	钅 宀 豕
镔	钅 宀 斤 八
镖	钅 西 示
镗	钅 尚 土
镘	钅 日 罒 又
镙	钅 田 糸
镛	钅 广 肀 月
镜	钅 立 日 儿
镝	钅 亠 丷 古
镞	钅 方 𠂉 矢
镟	钅 方 𠂉 龰
镡	钅 西 早
镢	钅 厂 䒑 欠
镣	钅 大 丷 小
镤	钅 业 䒑 夫
镥	钅 鱼 日
镦	钅 {京頭} 子 夊
镧	钅 门 木 丷
镨	钅 䒑 业 日
镩	钅 穴 口 丨
镪	钅 弓 口 虫
镫	钅 癶 一 䒑
镬	钅 艹 隹 又
镭	钅 雨 田
镯	钅 罒 勹 虫
镰	钅 广 䒑 八
镱	钅 立 日 心
镲	钅 宀 {祭上} 示
镳	钅 鹿 灬
镶	钅 {京頭} 口 𧘇
长	长
门	门
闩	门 一
闪	门 人
闫	门 三
闭	门 {于下} 丿
问	门 口
闯	门 马
闰	门 王
闱	门 キ 乛
闲	门 木
闳	门 {左上} 厶
间	门 日
闵	门 文
闶	门 亠 几
闷	门 心
闸	门 甲
闹	门 亠 巾
闺	门 土 土
闻	门 耳
闼	门 大 辶
闽	门 虫
闾	门 口 口
阀	门 亻 戈
阁	门 夊 口
阂	门 亥
阃	门 囗 木
阄	门 冖 电
阅	门 丷 口 儿
阆	门 丶 艮
阈	门 戈 口 一
阉	门 大 电
阊	门 日 日
阋	门 臼 儿
阌	门 爪 冖 又
阍	门 {卬左} 七 日
阎	门 冖 臼
阏	门 方 人 ⺀
阐	门 丷 日 十
阑	门 木 囗 丷
阒	门 目 犬
阔	门 氵 舌
阕	门 癶 一 大
阖	门 土 厶 皿
阗	门 十 且 八
阙	门 䒑 屮 欠
阚	门 乛 耳 夊
阜	𠂤 十
阝	阝
队	阝 人
阡	阝 千
阢	阝 兀
阪	阝 ⺁ 又
阮	阝 一 兀
阱	阝 二 {介下}
防	阝 方
阳	阝 日
阴	阝 月
阵	阝 车
阶	阝 人 {介下}
阻	阝 且
阼	阝 𠂉 {乍下}
阽	阝 卜 口
阿	阝 丁 口
陀	阝 宀 匕
陂	阝 皮
附	阝 亻 寸
际	阝 示
陆	阝 キ 凵
陇	阝 尤 丿
陈	阝 七 小
陉	阝 ス 工
陋	阝 一 冂 乚
陌	阝 丆 日
降	阝 夊 ヰ
限	阝 艮
陔	阝 亥
陕	阝 夫 丷
陛	阝 匕 匕 土
陟	阝 止 小
陡	阝 走
院	阝 宀 一 兀
除	阝 人 一 木
陧	阝 日 土
陨	阝 口 贝
险	阝 人 一 {兴上}
陪	阝 立 口
陬	阝 耳 又
陲	阝 壬 龷
陴	阝 {卑上} 十
陵	阝 土 八 夊
陶	阝 勹 缶
陷	阝 冖 臼
隅	阝 禺
隆	阝 夊 一 生
隈	阝 田 {畏下}
隋	阝 {左上} 工 月
隍	阝 白 王
随	阝 {左上} 月 辶
隐	阝 冖 彐 心
隔	阝 一 口 丨
隗	阝 鬼
隘	阝 䒑 八 皿
隙	阝 小 日 小
障	阝 立 早
隧	阝 䒑 豕 辶
隰	阝 日 幺 灬
隳	阝 {左上} 工 丶
隶	彐 水
隹	隹
隼	隹 十
隽	隹 乃
难	又 隹
雀	小 隹
雁	厂 亻 隹
雄	{左上} 厶 隹
雅	牙 隹
集	隹 木
雇	户 隹
雉	矢 隹
雌	止 匕 隹
雍	亠 {纟上} 丿 隹
雎	且 隹
雏	冖 彐 隹
雒	夊 口 隹
雕	⺆ 土 口 隹
雠	隹 讠 隹
雨	雨
雩	雨 一 丂
雪	雨 彐
雯	雨 文
雳	雨 厂 力
零	雨 人 丶 マ
雷	雨 田
雹	雨 勹 巳
雾	雨 夊 力
需	雨 而
霁	雨 文 {介下}
霄	雨 小 月
霆	雨 壬 廴
震	雨 辰
霈	雨 氵 一 巾
霉	雨 𠂉 母
霍	雨 隹
霎	雨 立 女
霏	雨 非
霓	雨 臼 儿
霖	雨 木 木
霜	雨 木 目
霞	雨 尸 二 又
霪	雨 氵 爪 壬
霭	雨 讠 日 乚
霰	雨 龷 月 夊
露	雨 足 夊 口
霸	雨 革 月
霹	雨 尸 口 辛
霾	雨 豸 里
青	龶 月
靓	龶 月 见
靖	立 龶 月
静	龶 月 冖 亅
靛	龶 月 宀 龰
非	非
靠	⺧ 口 非
靡	麻 非
面	面
靥	厂 犬 面
革	革
靳	革 斤
靴	革 亻 匕
靶	革 巴
靼	革 日 一
鞅	革 冂 大
鞋	革 土 土
鞍	革 宀 女
鞑	革 大 辶
鞒	革 夭 {介下}
鞔	革 冖 口 儿
鞘	革 小 月
鞠	革 勹 米
鞣	革 予 丿 木
鞫	革 勹 言
鞭	革 亻 一 乂
鞯	革 艹 {左上} 子
鞲	革 {冓上} 冂 土
鞴	革 龷 丿 用
韦	キ 乛
韧	キ 乛 刀 丶
韩	十 早 キ 乛
韪	日 一 龰 乛
韫	キ 乛 日 皿
韬	キ 乛 爪 臼
韭	非 一
音	立 日
韵	立 日 勹 二
韶	立 日 刀 口
页	丆 贝
顶	丁 丆 贝
顷	匕 丆 贝
顸	干 丆 贝
项	工 丆 贝
顺	川 丆 贝
须	彡 丆 贝
顼	王 丆 贝
顽	一 兀 丆 贝
顾	厂 㔾 丆 贝
顿	七 凵 丆 贝
颀	斤 丆 贝
颁	八 刀 丆 贝
颂	八 厶 丆 贝
颃	亠 几 丆 贝
预	予 丆 贝
颅	卜 尸 丆 贝
领	人 丶 マ 贝
颇	皮 丆 贝
颈	ス 工 丆 贝
颉	士 口 丆 贝
颊	夫 丷 丆 贝
颌	合 丆 贝
颍	匕 水 丆 贝
颏	亥 丆 贝
颐	臣 丆 贝
频	止 小 丆 贝
颓	禾 几 丆 贝
颔	人 丶 乛 贝
颖	匕 禾 丆 贝
颗	日 木 丆 贝
题	日 一 龰 贝
颚	口 口 一 贝
颛	山 而 丆 贝
颜	立 丿 彡 贝
额	宀 夊 口 贝
颞	耳 又 又 贝
颟	艹 一 冂 贝
颠	十 且 八 贝
颡	又 又 又 贝
颢	日 {京頭} 小 贝
颤	亠 囗 口 贝
颥	雨 而 丆 贝
颦	止 小 丆 十
颧	艹 口 口 贝
风	几 乂
飑	几 乂 勹 巳
飒	立 几 乂
飓	几 乂 且 八
飕	几 乂 臼 又
飘	西 示 几 乂
飙	犬 犬 犬 乂
飚	几 乂 火 火
飞	乛 二
食	食
飧	夕 食
飨	{纟上} 丿 食
餍	厂 犬 食
餐	卜 夕 又 食
餮	一 夕 人 食
饔	亠 {纟上} 丿 食
饕	口 丂 虎 食
饣	饣
饥	饣 几
饧	饣 𠄎 {两撇}
饨	饣 七 凵
饩	饣 气
饪	饣 壬
饫	饣 夭
饬	饣 𠂉 力
饭	饣 ⺁ 又
饮	饣 欠
饯	饣 一 戈
饰	饣 𠂉 巾
饱	饣 勹 巳
饲	饣 乛 一 口
饴	饣 厶 口
饵	饣 耳
饶	饣 七 丿 兀
饷	饣 向
饺	饣 亠 八 乂
饼	饣 䒑 卄
饽	饣 十 冖 子
饿	饣 丿 扌 戈
馀	饣 人 一 木
馁	饣 爪 女
馄	饣 日 匕 匕
馅	饣 冖 臼
馆	饣 宀 尸 コ
馇	饣 木 日 一
馈	饣 口 丄 贝
馊	饣 臼 丨 又
馋	饣 冖 口 ⺀
馍	饣 艹 日 大
馏	饣 卯 田
馐	饣 羊 丑
馑	饣 革 二
馒	饣 日 罒 又
馓	饣 龷 月 夊
馔	饣 巳 巳 八
馕	饣 十 口 𧘇
首	䒑 自
馗	九 䒑 自
馘	䒑 自 戈 一
香	禾 日
馥	禾 日 𠂉 夊
馨	士 {眉上} 殳 日
马	马
驭	马 又
驮	马 大
驯	马 川
驰	马 也
驱	马 匚 乂
驳	马 乂 乂
驴	马 户
驵	马 且
驶	马 口 乂
驷	马 囗 儿
驸	马 亻 寸
驹	马 勹 口
驺	马 冖 彐
驻	马 丶 王
驼	马 宀 匕
驽	女 又 马
驾	力 口 马
驿	马 又 キ
骀	马 厶 口
骁	马 七 丿 兀
骂	口 口 马
骄	马 夭 {介下}
骅	马 亻 匕 十
骆	马 夊 口
骇	马 亥
骈	马 䒑 卄
骊	马 一 {冂丶} {冂丶}
骋	马 由 丂
验	马 人 一 {兴上}
骏	马 厶 八 夊
骐	马 其
骑	马 大 丁 口
骒	马 日 木
骓	马 隹
骖	马 厶 大 彡
骗	马 户 冊
骘	阝 止 小 马
骚	马 又 丶 虫
骛	予 丿 夊 马
骜	龶 勹 夊 马
骝	马 卯 田
骞	宀 {冓上} 八 马
骟	马 户 习 习
骠	马 西 示
骡	马 田 糸
骢	马 {囟框} 夊 心
骣	马 尸 子 子
骤	马 耳 又 二
骥	马 丬 匕 八
骧	马 {京頭} 口 𧘇
骨	骨
骰	骨 殳
骱	骨 人 {介下}
骶	骨 {卬左} 七 丶
骷	骨 古
骸	骨 亥
骺	骨 ⺁ 一 口
骼	骨 夊 口
髀	骨 {卑上} 十
髁	骨 日 木
髂	骨 宀 夊 口
髅	骨 米 女
髋	骨 宀 艹 见
髌	骨 宀 斤 八
髑	骨 罒 勹 虫
髓	骨 {左上} 工 辶
高	高
髟	髟
髡	髟 兀
髦	髟 毛
髫	髟 刀 口
髭	髟 止 匕
髯	髟 冂 土
髹	髟 亻 木
髻	髟 士 口
鬃	髟 宀 示
鬈	髟 丷 夫 㔾
鬏	髟 禾 火
鬓	髟 宀 斤 八
鬟	髟 罒 一 𧘇
鬣	髟 巛 囗 {鼠下}
鬯	𠂭 凵 匕
鬲	一 口 冂 丨
鬻	弓 米 弓 丨
鬼	鬼
魁	鬼 ⺀ 十
魂	二 厶 鬼
魃	鬼 {左上} 又 丶
魄	白 鬼
魅	鬼 未
魇	厂 犬 鬼
魈	鬼 小 月
魉	鬼 一 冂 人
魍	鬼 冂 䒑 亡
魏	禾 女 鬼
魑	鬼 文 凵 厶
魔	麻 鬼
鱼	鱼
鱿	鱼 尤
鲁	鱼 日
鲂	鱼 方
鲅	鱼 {左上} 又 丶
鲆	鱼 干 丷
鲇	鱼 卜 口
鲈	鱼 卜 尸
鲋	鱼 亻 寸
鲍	鱼 勹 巳
鲎	⺍ 冖 鱼
鲐	鱼 厶 口
鲑	鱼 土 土
鲒	鱼 士 口
鲔	鱼 {左上} 月
鲕	鱼 而
鲚	鱼 文 {介下}
鲛	鱼 亠 八 乂
鲜	鱼 羊
鲞	丷 夫 鱼
鲟	鱼 彐 寸
鲠	鱼 一 日 乂
鲡	鱼 一 {冂丶} {冂丶}
鲢	鱼 车 辶
鲣	鱼 〢 又 土
鲤	鱼 里
鲥	鱼 日 寸
鲦	鱼 夊 木
鲧	鱼 丿 糸
鲨	氵 小 丿 鱼
鲩	鱼 宀 一 兀
鲫	鱼 彐 厶 卩
鲭	鱼 龶 月
鲮	鱼 土 八 夊
鲰	鱼 耳 又
鲱	鱼 非
鲲	鱼 日 匕 匕
鲳	鱼 日 日
鲴	鱼 囗 古
鲵	鱼 臼 儿
鲶	鱼 人 丶 心
鲷	鱼 ⺆ 土 口
鲸	鱼 {京頭} 小
鲺	鱼 乛 丿 虫
鲻	鱼 巛 田
鲼	鱼 十 卄 贝
鲽	鱼 世 木
鳃	鱼 田 心
鳄	鱼 口 口 丂
鳅	鱼 禾 火
鳆	鱼 𠂉 日 夊
鳇	鱼 白 王
鳊	鱼 户 冊
鳋	鱼 又 丶 虫
鳌	龶 勹 夊 鱼
鳍	鱼 耂 匕 日
鳎	鱼 日 习 习
鳏	鱼 罒 水
鳐	鱼 爪 缶
鳓	鱼 革 力
鳔	鱼 西 示
鳕	鱼 雨 彐
鳖	丷 巾 八 鱼
鳗	鱼 日 罒 又
鳘	𠂉 母 夊 鱼
鳙	鱼 广 肀 月
鳜	鱼 厂 䒑 欠
鳝	鱼 羊 䒑 口
鳞	鱼 米 夕 ヰ
鳟	鱼 丷 酉 寸
鳢	鱼 冂 龷 䒑
鸟	鸟
鸠	九 鸟
鸡	又 鸟
鸢	弋 鸟
鸣	口 鸟
鸥	匚 乂 鸟
鸦	牙 鸟
鸨	匕 十 鸟
鸩	冖 儿 鸟
鸪	古 鸟
鸫	七 小 鸟
鸬	卜 尸 鸟
鸭	甲 鸟
鸯	冂 大 鸟
鸱	{卬左} 七 丶 鸟
鸲	勹 口 鸟
鸳	夕 㔾 鸟
鸵	鸟 宀 匕
鸶	{纟上} 纟 鸟
鸷	扌 九 丶 鸟
鸸	而 鸟
鸹	舌 鸟
鸺	亻 木 鸟
鸽	合 鸟
鸾	亦 鸟
鸿	氵 工 鸟
鹁	十 冖 子 鸟
鹂	一 {冂丶} {冂丶} 鸟
鹃	口 月 鸟
鹄	⺧ 口 鸟
鹅	丿 扌 戈 鸟
鹆	八 人 口 鸟
鹇	门 木 鸟
鹈	丷 弓 丨 鸟
鹉	一 弋 止 鸟
鹊	龷 日 鸟
鹋	艹 田 鸟
鹌	大 电 鸟
鹎	{卑上} 十 鸟
鹏	月 月 鸟
鹑	{京頭} 子 鸟
鹕	古 月 鸟
鹗	口 口 一 鸟
鹘	骨 鸟
鹚	䒑 幺 幺 鸟
鹛	{眉上} 目 鸟
鹜	予 丿 夊 鸟
鹞	爪 缶 鸟
鹣	䒑 彐 〢 鸟
鹤	冖 隹 鸟
鹦	贝 贝 女 鸟
鹧	广 卄 一 鸟
鹨	习 习 人 鸟
鹩	大 丷 日 鸟
鹪	隹 灬 鸟
鹫	{京頭} 小 尤 鸟
鹬	予 丿 冂 鸟
鹭	足 夊 口 鸟
鹰	广 亻 隹 鸟
鹱	鸟 艹 隹 又
鹳	艹 口 口 鸟
鹾	卜 囗 乂 工
鹿	鹿
麂	鹿 几
麇	鹿 禾
麈	鹿 丶 王
麋	鹿 米
麒	鹿 其
麓	木 木 鹿
麝	鹿 身 寸
麟	鹿 米 夕 ヰ
麦	龶 夊
麴	來 夊 勹 米
麸	龶 夊 夫
麻	麻
麽	麻 丿 厶
麾	麻 毛
黄	龷 由 八
黉	⺍ 冖 龷 八
黍	禾 人 水
黎	禾 勹 丿 水
黏	禾 人 水 口
黑	黑
黔	黑 人 丶 乛
默	黑 犬
黛	亻 弋 黑
黜	黑 屮 凵
黝	黑 幺 力
黟	黑 夕 夕
黠	黑 士 口
黢	黑 厶 八 夊
黥	黑 {京頭} 小
黧	禾 勹 丿 黑
黩	黑 十 乛 大
黪	黑 厶 大 彡
黯	黑 立 日
黹	业 丷 巾 八
黻	业 丷 巾 丶
黼	业 丷 巾 甫
黾	口 电
鼋	一 兀 口 电
鼍	口 口 田 电
鼎	目 爿 片
鼐	乃 目 爿 片
鼓	士 口 䒑 又
鼗	儿 二 二 又
鼙	士 口 䒑 十
鼠	臼 {鼠下}
鼢	臼 {鼠下} 八 刀
鼬	臼 {鼠下} 由
鼯	臼 {鼠下} 一 口
鼷	臼 {鼠下} 爪 大
鼹	臼 {鼠下} 日 女
鼻	自 田 丌
鼽	自 田 丌 九
鼾	自 田 丌 干
齄	自 田 丌 一
齐	文 {介下}
齑	文 {介下} 非 一
齿	止 人 凵
龀	止 人 凵 匕
龃	止 人 凵 且
龄	止 人 凵 マ
龅	止 人 凵 巳
龆	止 人 凵 口
龇	止 人 凵 匕
龈	止 人 凵 艮
龉	止 人 凵 口
龊	止 人 凵 足
龋	止 人 凵 冂
龌	止 人 凵 至
龙	尤 丿
龚	尤 丿 龷 八
龛	合 尤 丿
龟	冖 电
龠	合 口 口 冊
丂	丂
丄	丄
丅	丅
丆	丆
丏	丅 乚 乛
丒	刀 丶 一
丗	卅 一
丟	王 厶
丠	丬 匕 一
両	一 冂 山
丣	丌 匚 コ
並	䒑 业
丩	丩
丮	乛 キ
丯	彡 丨
丱	丱
丳	口 口 {介下}
丵	业 䒑 十
丷	丷
丼	卄 亠
乀	乀
乁	乁
乂	乂
乄	亅 丶
乆	乚 人
乊	丿 丷
乑	亻 {两撇} 二
乕	⺁ 二 巾
乗	禾 龷
乚	乚
乛	乛
乢	山 乚
乣	幺 乚
乤	下 乙
乥	丿 丷 乙
乧	⺀ 十 乙
乨	厶 口 乚
乪	乙 田
乫	力 口 乙
乬	匚 コ 乙
乭	石 乙
乮	卯 乙
乯	丿 丷 {于下} 乙
乲	二 欠 乙
乴	扌 斤 乙
乵	辛 乚
乶	甫 乙
乷	氵 小 丿 乙
乸	也 母
乹	十 早 乚
乺	戶 斤 乙
乻	方 人 ⺀ 乙
乼	氵 丶 王 乙
乽	耂 日 乙
乿	爪 糸 乚
亀	冖 日 电
亁	十 日 干 乙
亂	爪 マ 冂 乚
亃	米 夕 ヰ 乚
亄	士 冖 一 乚
亅	亅
亇	冖 亅
亊	{于下} 丷 彐
亐	二 ㇉
亖	二 二
亗	山 二
亙	一 月 一
亜	丌 口 一
亝	厶 厶 厶 二
亞	一 {亞下}
亣	丶 丌
亪	亦 乁
亯	{京頭} 日
亰	亠 日 小
亱	亠 亻 日 一
亴	{亮頭} 土 九
亶	亠 囗 口 一
亷	立 丿 彐 八
亸	{京頭} 子 丷 十
亹	亠 臼 冂 且
亼	人 一
亽	人 丶
亾	人 乚
仈	亻 八
仌	人 人
仏	亻 厶
仐	人 十
仒	人 ⺀
仚	人 山
仛	亻 丿 七
仜	亻 工
仠	亻 干
仢	亻 勹 丶
仦	亻 小
仧	上 人
仩	亻 上
仭	亻 刀 乀
仮	亻 ⺁ 又
仯	亻 小 丿
仱	亻 人 丶 乛
仴	亻 月
仸	亻 夭
仹	亻 丰
仺	人 {反彐}
仼	亻 王
仾	亻 一 彑
伀	亻 八 厶
伂	亻 一 巾
伃	亻 予
伄	亻 弓 丨
伅	亻 七 凵
伆	亻 勹 {两撇}
伇	亻 殳
伈	亻 心
伋	亻 乃 乀
伌	亻 厂 㔾
伒	亻 斤
伓	亻 不
伔	亻 冖 几
伕	亻 夫
伖	亻 {左上} 又
伜	亻 九 十
伝	亻 二 厶
伡	亻 车
伣	亻 见
伨	亻 勹 二
伩	亻 文
伬	亻 尸 乀
伭	亻 亠 幺
伮	亻 女 又
伱	亻 人 小
伳	亻 世
伵	亻 囗 儿
伷	亻 由
伹	亻 且
伻	亻 干 丷
伾	亻 不 一
伿	亻 口 八
佀	亻 尸 コ
佁	亻 厶 口
佂	亻 一 止
佄	亻 卄 二
佅	亻 未
佇	亻 宀 丁
佈	亻 {左上} 巾
佉	亻 土 厶
佊	亻 皮
佋	亻 刀 口
佌	亻 止 匕
佒	亻 冂 大
佔	亻 卜 口
佖	亻 心 丿
佡	亻 人 山
佢	亻 匚 コ
佦	亻 石
佨	亻 勹 巳
佪	亻 囗 口
佫	亻 夊 口
佭	亻 夊 ヰ
佮	亻 合
佱	人 二 止
佲	亻 夕 口
併	亻 䒑 卄
佷	亻 艮
佸	亻 舌
佹	亻 冖 厂 㔾
佺	亻 人 王
佽	亻 二 欠
侀	亻 一 卄 刂
侁	亻 ⺧ 儿
侂	亻 广 丿 七
侅	亻 亥
來	來
侇	亻 大 弓
侊	亻 小 兀
侌	人 丶 乛 厶
侎	亻 米
侐	亻 丿 皿
侒	亻 宀 女
侓	亻 彐 キ
侕	亻 而
侖	人 一 冊
侘	亻 宀 丿 七
侙	亻 弋 工
侚	亻 勹 日
侜	亻 舟
侞	亻 女 口
侟	亻 {左上} 丨 子
価	亻 西
侢	亻 王 冂
侤	亻 耂 丂
侫	亻 亡 女
侭	亻 尸 乀 ⺀
侰	亻 彐 丿 口
侱	亻 口 王
侲	亻 辰
侳	亻 人 人 土
侴	人 一 丑 刂
侶	亻 口 {囟框}
侷	亻 尸 乛 口
侸	亻 一 口 䒑
侹	亻 壬 廴
侺	亻 山 人 乛
侻	亻 丷 口 儿
侼	亻 十 冖 子
侽	亻 田 力
侾	亻 耂 子
俀	亻 爪 女
俁	亻 口 ㇉ 大
係	亻 丿 糸
俆	亻 人 一 木
俇	亻 犭 王
俈	亻 ⺧ 口
俉	亻 一 {五下} 口
俋	亻 口 巴
俌	亻 甫
俍	亻 丶 艮
俒	亻 宀 一 兀
俓	亻 一 巛 工
俔	亻 見
俕	亻 宀 木
俖	亻 不 口
俙	亻 乂 {左上} 巾
俛	亻 冖 口 儿
俠	亻 大 人 人
俢	亻 夊 彡
俤	亻 丷 弓 丿
俥	亻 車
俧	亻 士 心
俫	亻 一 米
俬	亻 禾 厶
俰	亻 禾 口
俲	亻 亠 八 力
俴	亻 戈 戈
俵	亻 龶 𧘇
俶	亻 上 小 又
俷	亻 月 巴
俹	亻 一 {亞下}
俻	亻 夊 田
俼	亻 亠 厶 月
俽	亻 斤 欠
俿	亻 虎
倀	亻 長
倁	亻 矢 口
倂	亻 丿 干 干
倃	亻 夊 卜 口
倄	亻 乂 {左上} 月
倅	亻 亠 人 十
倆	亻 一 巾 入
倇	亻 宀 夕 㔾
倈	亻 來
倉	人 丶 彐 口
倊	亻 八 厶 心
個	亻 囗 古
倎	亻 冂 龷 八
倐	亻 丨 夊 火
們	亻 門
倓	亻 火 火
倕	亻 壬 龷
倖	亻 土 䒑 十
倗	亻 月 月
倛	亻 其
倝	十 早 人
倞	亻 {京頭} 小
倠	亻 隹
倢	亻 一 彐 龰
倣	亻 方 夊
値	亻 十 目 乚
倧	亻 宀 示
倫	亻 人 一 冊
倯	亻 木 八 厶
倰	亻 土 八 夊
倱	亻 日 匕 匕
倲	亻 木 日
倳	亻 {于下} 口 彐
倴	亻 大 十 卄
倵	亻 一 弋 止
倶	亻 目 一 八
倷	亻 大 示
倸	亻 爪 木
倹	亻 合 人
倻	亻 耳 阝
倽	亻 人 干 口
倿	亻 立 女
偀	亻 艹 冂 大
偁	亻 爪 冂 土
偂	亻 䒑 月 刂
偄	亻 而 大
偅	亻 千 里
偆	亻 𡗗 日
偉	亻 韋
偊	亻 丿 虫 冂
偋	亻 尸 䒑 卄
偍	亻 日 一 龰
偐	亻 立 丿 彡
偑	亻 風
偒	亻 日 一 {两撇}
偓	亻 尸 至
偔	亻 口 口 丂
偖	亻 耂 日
偗	亻 小 丿 目
偘	亻 口 口 口
偙	亻 亠 丷 巾
偛	亻 千 臼
偝	亻 丬 匕 月
偞	亻 世 木
偟	亻 白 王
偠	亻 西 女
偡	亻 其 乚
偢	亻 禾 火
偣	亻 立 日
偤	亻 丷 酉
偦	亻 乛 龰 月
偧	亻 大 夕 夕
偨	亻 止 匕 木
偩	亻 冖 貝
偪	亻 一 口 田
偫	亻 彳 土 寸
偭	亻 面
偮	亻 口 耳
偯	亻 {京頭} 𧘇
偰	亻 丰 刀 大
偱	亻 ⺁ 十 目
偲	亻 田 心
偳	亻 山 而
側	亻 貝 刂
偵	亻 卜 貝
偸	亻 入 一 巜
偹	亻 丨 夊 田
偺	亻 夊 卜 日
偼	亻 卜 彐 龰
偽	亻 丶 {爲下}
傁	亻 臼 丨 又
傂	亻 ⺁ 虎
傃	亻 龶 糸
傄	亻 大 丷 目
傆	亻 厂 白 小
傇	亻 艹 耳
傉	亻 辰 寸
傊	亻 口 貝
傋	亻 {冓上} 冂 土
傌	亻 馬
傎	亻 十 且 八
傏	亻 广 肀 口
傐	亻 高
傑	亻 夕 ヰ 木
傒	亻 爪 幺 大
傓	亻 户 习 习
傔	亻 䒑 彐 八
傕	亻 冖 隹
傖	亻 人 丶 口
傗	亻 亠 幺 田
傘	人 人 人 十
備	亻 龷 丿 用
傚	亻 亠 八 夊
傛	亻 穴 人 口
傜	亻 爪 缶
傝	亻 日 习 习
傞	亻 羊 工
傟	亻 八 厶 习
傠	亻 言 寸
傡	亻 立 立
傢	亻 宀 豕
傤	亻 十 戈 车
傦	亻 骨
傪	亻 厶 厶 彡
傫	亻 田 糸
傭	亻 广 肀 月
傮	亻 艹 日 日
傯	亻 {囟框} 夊 心
傰	亻 山 月 月
傱	亻 彳 人 龰
傳	亻 {專上} 寸
傴	亻 匚 口 口
債	亻 龶 貝
傶	亻 戊 上 小
傷	亻 𠂉 日 {两撇}
傸	亻 大 乂 乂
傹	亻 立 日 儿
傼	亻 卄 一 夫
傽	亻 立 早
傾	亻 匕 丆 貝
傿	亻 一 止 灬
僀	亻 卌 一 巾
僁	亻 丿 米 心
僂	亻 口 十 女
僃	亻 艹 勹 用
僄	亻 西 示
僅	亻 革 二
僆	亻 車 辶
僇	亻 习 习 彡
僈	亻 日 罒 又
僉	僉
僊	亻 西 大 巳
僋	亻 人 丶 貝
僌	亻 車 夊
働	亻 千 里 力
僎	亻 巳 巳 八
僐	亻 羊 䒑 口
僑	亻 夭 口 口
僒	亻 穴 彐 口
僓	亻 口 丄 貝
僔	亻 丷 酉 寸
僕	亻 业 䒑 夫
僗	亻 火 火 力
僘	亻 尚 夊
僙	亻 龷 由 八
僛	亻 其 欠
僜	亻 癶 一 䒑
僝	亻 尸 子 子
僞	亻 爪 {爲下}
僟	亻 幺 幺 人
僠	亻 丿 米 田
僡	亻 {專上} 心
僢	亻 爪 冖 ヰ
僣	亻 夫 夫 日
僤	亻 口 口 十
僥	亻 土 土 兀
僨	亻 十 卄 貝
僩	亻 門 月
僪	亻 予 丿 口
僫	亻 一 {亞下} 心
僯	亻 米 夕 ヰ
僰	木 冂 木 人
僱	亻 户 隹
僲	亻 西 夕 ヰ
僴	亻 門 日
僶	亻 黽
僷	亻 艹 世 木
僸	亻 木 木 示
價	亻 西 貝
僺	亻 口 口 木
僼	亻 冂 龷 䒑
僽	亻 禾 火 心
僾	亻 爪 冖 夊
僿	亻 宀 {冓上} 土
儀	亻 羊 丿 戈
儁	亻 隹 {雋下}
儂	亻 冂 龷 辰
儃	亻 亠 囗 一
億	亻 立 日 心
儅	亻 尚 田
儈	亻 人 一 日
儉	亻 僉
儊	亻 木 木 龰
儌	亻 白 方 夊
儍	亻 𠂭 凵 夊
儎	亻 十 戈 車
儏	亻 卜 夕 米
儐	亻 宀 一 貝
儑	亻 日 幺 灬
儓	亻 士 口 至
儔	亻 士 乛 寸
儕	亻 亠 丷 二
儖	亻 臣 {⺮右} 皿
儗	亻 匕 矢 龰
儘	亻 肀 一 皿
儙	亻 口 丄 辶
儚	亻 艹 罒 夕
儛	亻 𠂉 卅 ヰ
儜	亻 宀 心 丁
儝	亻 火 火 木
儞	亻 一 八 乂
償	亻 尚 貝
儠	亻 巛 囗 {鼠下}
儢	亻 {虎头} 田 心
儣	亻 广 龷 八
儤	亻 日 龷 水
儥	亻 士 罒 貝
儦	亻 鹿 灬
儧	亻 夫 夫 貝
儨	亻 斤 斤 貝
儩	亻 貝 日 {两撇}
優	亻 丆 月 夊
儫	亻 {亮頭} 豕
儬	亻 龶 月 見
儭	亻 立 木 見
儮	亻 厂 禾 止
儯	亻 丷 夫 馬
儰	亻 艹 爪 {爲下}
儱	亻 立 月 {龍右}
儲	亻 言 耂 日
儳	亻 冖 口 丶
儴	亻 {京頭} 口 𧘇
儵	亻 丨 夊 黑
儶	亻 山 隹 口
儷	亻 一 {冂丶} 鹿
儸	亻 罒 糹 隹
儹	亻 ⺧ 儿 貝
儺	亻 卄 一 隹
儻	亻 尚 黑
儼	亻 口 口 夊
儽	亻 田 田 糸
儾	亻 十 口 𧘇
兂	匚 儿
兇	乂 凵 儿
兊	八 厶 儿
兌	八 口 儿
兎	丿 口 儿 丶
兏	⺁ 上 儿
児	丨 日 儿
兒	臼 儿
兓	匚 儿 匚 儿
兗	亠 八 口 儿
兘	一 兀 厶 口
兙	古 儿 十
兛	古 儿 千
兝	古 儿 八 刀
兞	古 儿 毛
兟	⺧ 儿 ⺧ 儿
兠	白 丬 匕 儿
兡	古 儿 丆 日
兣	古 儿 厂 里
兤	小 兀 广 八
兦	入 乚
內	冂 入
兩	一 巾 入 入
兪	入 一 月 巜
兯	丷 卩
兲	王 八
兺	八 刀 口 匕
兾	丷 田 龷 八
兿	䒑 扌 九 厶
冃	冂 二
冄	冂 二
円	冂 丄
冇	{左上} 冂
冊	冊
冋	冂 口
冎	冎
冏	冂 八 口
冐	冂 二 月
冑	由 冂 二
冓	{冓上} 冂 土
冔	冂 二 口 {于下}
冘	冖 儿
冚	冖 山
冝	冖 且
冞	冖 米
冟	冖 白 匕
冡	冖 一 豕
冣	冖 耳 又
冦	冖 一 兀 又
冧	冖 木 木
冨	冖 一 口 田
冩	冖 臼 勹 灬
冪	冖 艹 日 巾
冭	大 ⺀
冮	二 工
冴	二 牙
冸	二 丷 キ
冹	二 {左上} 又 丶
冺	二 巳 七
冾	二 合
冿	二 彐 キ
凁	二 木 口
凂	二 冖 口 儿
凃	二 人 一 木
凅	二 囗 古
凈	二 爪 彐 亅
凊	二 龶 月
凍	二 木 日
凎	二 金
凐	二 西 土
凒	二 山 一 䒑
凓	二 西 木
凔	二 人 丶 口
凕	二 冖 日 八
凖	二 隹 十
凗	二 山 隹
凘	二 其 斤
凙	二 罒 土 十
凚	二 木 木 示
凜	二 亠 囗 禾
凞	二 丿 臣 灬
凟	二 士 罒 貝
凢	丿 几
凣	丨 几
凥	尸 几
処	夊 几
凧	几 巾
凨	几 二 厶
凩	几 木
凪	几 止
凬	几 一 日
凮	几 丆 日
凱	山 一 口 几
凲	几 䒑 彐 八
凴	二 馬 几
凷	土 凵
凾	了 口 又 凵
刄	刀 乀
刅	刀 八
刉	𠂉 乙 刂
刋	千 刂
刌	寸 刂
刏	气 刂
刐	⺆ 亠 刂
刓	一 兀 刂
刔	コ 人 刂
刕	刀 刀 刀
刜	弓 {介下} 刂
刞	且 刂
刟	刀 口 刂
刡	巳 七 刂
刢	人 丶 マ 刂
刣	厶 口 刂
別	口 勹 刂
刦	土 厶 刂
刧	土 厶 刀
刪	冊 刂
刬	一 戈 刂
刯	一 日 一 刂
刱	二 {介下} 刀 八
刲	土 土 刂
刴	乃 木 刂
刵	耳 刂
刼	土 厶 刀 丶
刾	夫 丷 刂
剄	一 巛 工 刂
剅	一 口 䒑 刂
剆	丶 彐 厶 刂
則	貝 刂
剈	口 月 刂
剉	人 人 土 刂
剋	古 儿 刂
剎	乂 木 丶 刂
剏	䒑 卄 刀 丶
剒	龷 日 刂
剓	禾 勹 丿 刀
剕	非 刂
剗	戈 戈 刂
剘	其 刂
剙	䒑 卄 刀 八
剚	{于下} 口 彐 刂
剛	冂 䒑 山 刂
剝	彑 水 刂
剟	又 又 又 刂
剠	{京頭} 小 刂
剢	豕 丶 刂
剣	合 人 刂
剤	文 {介下} 二 刂
剦	大 电 刂
剨	丰 石 刂
剫	广 卄 一 刂
剬	山 而 刂
剭	尸 至 刂
剮	咼 刂
剰	禾 龷 刂
剱	合 人 刀 丶
剳	艹 合 刂
剴	山 一 口 刂
創	人 丶 彐 刂
剶	{互中} 豕 刂
剷	立 丿 生 刂
剸	{專上} 寸 刂
剹	习 习 人 刂
剺	未 夊 厂 刀
剻	山 月 月 刂
剼	厶 厶 厶 刂
剾	匚 口 口 刂
劀	予 丿 冂 刂
劃	彐 土 田 刂
劄	竹 合 刂
劅	罒 勹 虫 刂
劆	广 䒑 彐 刂
劇	{虎头} 豕 刂
劉	卯 金 刂
劊	人 一 日 刂
劋	口 口 口 刂
劌	止 戊 一 刂
劍	僉 刂
劎	僉 刀
劏	尚 田 刂
劑	亠 丷 丨 刂
劒	僉 刀 丶
劔	僉 刀 乀
劕	斤 斤 貝 刂
劖	冖 口 匕 刂
劗	⺧ 儿 ⺧ 刂
劘	麻 非 刂
劙	{互中} 豕 虫 刂
劚	尸 水 罒 刂
劜	力 乚
劤	斤 力
劥	亠 几 力
劦	力 力 力
劧	手 力
劮	丿 夫 力
劯	石 力
劰	白 力
労	⺍ 冖 力
劵	丷 夫 力
劶	⺁ 一 口 力
劷	羊 力
劸	土 土 力
効	亠 八 乂 力
劺	厶 牛 力
劻	匚 王 力
劼	士 口 力
劽	一 夕 刂 力
勀	古 儿 力
勁	一 巛 工 力
勂	⺧ 口 力
勄	𠂉 母 力
勅	木 口 力
勆	丶 彐 厶 力
勈	マ 用 力
勊	古 儿 力
勌	丷 夫 㔾 力
勍	{京頭} 小 力
勎	土 八 土 力
勏	立 口 力
勑	來 力
勓	匕 匕 白 力
勔	面 力
動	千 里 力
勗	日 且 力
務	予 丿 夊 力
勚	世 贝 力
勛	口 貝 力
勜	八 厶 习 力
勝	月 丷 夫 力
勞	火 火 冖 力
勠	习 习 人 力
勡	西 示 力
勢	土 八 土 力
勣	龶 貝 力
勥	弓 口 虫 力
勦	巛 日 木 力
勧	𠂉 一 隹 力
勨	冖 口 豕 力
勩	世 貝 力
勪	夭 口 冂 力
勫	丿 米 田 力
勬	丷 夫 糸 力
勭	立 里 力
勮	{虎头} 豕 力
勯	亠 囗 口 力
勱	艹 禺 力
勲	千 里 力 灬
勳	千 黑 力
勴	{虎头} 田 心 力
勵	厂 艹 禺 力
勶	彳 亠 厶 力
勷	{京頭} 口 {冓上} 力
勸	艹 口 口 力
勻	勹 二
勼	勹 九
勽	勹 人
匁	勹 乂
匂	勹 匕
匃	勹 人 乚
匄	勹 亡
匇	勹 夕
匉	勹 干 丷
匊	勹 米
匋	勹 缶
匌	勹 合
匎	勹 大 电
匑	勹 身 弓
匒	勹 艹 合
匓	勹 彐 厶 殳
匔	勹 身 口 口
匘	匕 巛 {囟框} 乂
匛	匚 冖 丶
匜	匚 也
匞	匚 工
匟	匚 亠 几
匢	匚 勹 {两撇}
匤	匚 王 丶
匥	匚 厶 卄
匧	匚 大 人 人
匨	匚 爿 士
匩	匚 屮 王
匫	匚 勹 {两撇} 日
匬	匚 人 一 刂
匭	匚 車 九
匯	匚 氵 隹
匰	匚 口 口 十
匱	匚 口 丄 貝
匲	匚 大 口 口
匳	匚 僉
匴	匚 竹 目 卄
匵	匚 士 罒 貝
匶	匚 艹 隹 臼
匷	匚 目 目 隹
匸	匚
匼	匚 合
匽	匚 日 女
區	匚 口 口 口
卂	乛 十
卄	卄
卆	九 十
卋	十 卄 一
卌	卌
卍	乛 丨 一 丨
卐	乚 一 丨 一
協	十 力 力 力
単	⺍ 日 十
卙	其 乚 十
卛	言 糹 糹 十
卝	卝
卥	卜 囗 {两撇} 丶
卨	卜 咼
卪	卩 丶
卬	{卬左} 卩
卭	工 卩
卲	刀 口 卩
卶	夕 夕 卩
卹	丿 皿 卩
卻	八 人 口 卩
卼	兀 冖 厂 㔾
卽	白 匕 卩
卾	口 口 一 卩
厀	木 人 水 卩
厁	人 一 木 卩
厃	冖 厂
厇	厂 丿 七
厈	厂 干
厊	厂 牙
厎	厂 {卬左} 七 丶
厏	厂 𠂉 {乍下}
厐	厂 尤 丿
厑	厂 口 匕
厒	厂 缶
厓	厂 土 土
厔	厂 至
厖	厂 尤 彡
厗	厂 辛
厙	厂 車
厛	厂 口 斤
厜	厂 壬 龷
厞	厂 非
厠	厂 貝 刂
厡	厂 白 水
厤	厂 禾 禾
厧	厂 十 且 八
厪	厂 革 二
厫	厂 龶 勹 夊
厬	厂 日 夊 口
厭	厂 日 月 犬
厯	厂 木 木 ⺀
厰	厂 尚 夊
厱	厂 僉
厲	厂 艹 禺
厳	⺍ 厂 乛 夊
厴	厂 日 月 甲
厵	厂 白 小 小
厷	{左上} 厶
厸	厶 厶
厹	九 厶
厺	大 厶
厼	厶 小
厽	厶 厶 厶
厾	乛 土 厶
叀	叀
參	厶 厶 厶 彡
叄	厶 厶 厶 三
叅	厶 厶 厶 丶
叆	二 厶 爪 又
叇	二 厶 彐 辶
収	丩 又
叏	コ 丨 又
叐	千 又
叒	又 又 又
叓	十 口 又
叕	又 又 又 又
叚	尸 二 コ 又
叜	宀 火 又
叝	土 厶 卩 又
叞	尸 示 又
叡	卜 冖 一 又
叢	业 䒑 十 又
叧	口 刀
叴	九 口
叺	口 入
叾	了 口
叿	口 工
吀	口 千
吂	亡 口
吅	口 口
吇	口 子
吋	口 寸
吔	口 也
吘	口 𠂉 十
吙	口 火
吚	口 彐 丿
吜	口 丑
吢	心 口
吤	口 人 {介下}
吥	口 不
吪	口 亻 匕
吰	口 {左上} 厶
吳	口 ㇉ 大
吶	口 冂 入
吷	口 コ 人
吺	口 殳
吽	口 牛
吿	牛 口
呁	口 勹 二
呂	口 {囟框}
呄	乃 古
呅	口 文
呇	水 口
呉	口 ㇉ 一 八
呌	口 ⺀ 十
呍	口 二 厶
呎	口 尸 乀
呏	口 丿 卄
呑	夭 口
呚	口 夊
呝	口 户 乙
呞	口 乛 一 口
呟	口 亠 幺
呠	口 木 一
呡	口 巳 七
呣	口 母
呥	口 冂 土
呧	口 {卬左} 七 丶
呩	口 示
呪	口 口 儿
呫	口 卜 口
呬	口 囗 儿
呭	口 世
呮	口 口 八
呯	口 干 丷
呰	止 匕 口
呴	口 勹 口
呹	口 丿 夫
呺	口 口 丂
呾	口 日 一
呿	口 土 厶
咁	口 卄 二
咃	口 亻 也
咅	立 口
咇	口 心 丿
咈	口 弓 {介下}
咉	口 冂 大
咊	口 禾
咍	口 厶 口
咑	口 扌 丁
咓	口 瓦
咗	口 {左上} 工
咘	口 {左上} 巾
咜	口 宀 匕
咞	口 一 卄
咟	口 丆 日
咠	口 耳
咡	口 耳
咢	口 口 一 丂
咥	口 至
咮	口 牛 八
咰	口 勹 日
咲	口 䒑 大
咵	口 大 一 丂
咶	口 舌
咷	口 儿 二 二
咹	口 宀 女
咺	口 一 日 一
咼	咼
咾	口 耂 匕
哃	口 冂 一 口
哅	口 勹 乂 凵
哊	口 {左上} 月
哋	口 土 也
哖	口 𠂉 ヰ
哘	口 彳 亍
哛	口 匕 八 刀
哠	口 ⺧ 口
員	口 貝
哢	口 王 卄
哣	口 一 口 䒑
哤	口 尤 彡
哫	口 足
哬	口 亻 丁 口
哯	口 見
哰	口 宀 牛
哱	口 十 冖 子
哴	口 丶 艮
哵	口 口 力 刂
哶	口 卝 干
哷	口 爪 寸
哸	口 爪 女
哹	口 爪 子
哻	口 日 干
哾	口 丷 口 儿
唀	口 禾 乃
唂	口 八 人 口
唃	口 冖 用
唄	口 貝
唅	口 人 丶 口
唈	口 口 巴
唊	口 大 人 人
唋	口 人 一 木
唌	口 丿 止 廴
唍	口 宀 一 兀
唎	口 禾 刂
唒	口 酉
唓	口 車
唕	口 白 十
唖	口 丌 口 一
唗	口 走
唘	石 又 口
唙	口 犭 火
唚	口 彐 冖 又
唜	末 口 匕
唝	口 工 贝
唞	口 扌 ⺀ 十
唟	土 厶 口 匕
唡	口 一 冂 人
唥	口 二 人 マ
唦	口 氵 小 丿
唨	口 阝 且
唩	口 禾 女
唫	口 金
唭	口 其
唲	口 臼 儿
唴	口 羊 乚
唵	口 大 电
唶	口 龷 日
唸	口 人 丶 心
唹	口 方 人 ⺀
唺	口 冂 龷 八
唻	口 來
唽	口 木 斤
啀	口 厂 土 土
啂	口 爪 子 乚
啅	口 卜 早
啇	亠 丷 冂 古
啈	口 土 䒑 十
啋	口 爪 木
啌	口 穴 工
啍	口 {京頭} 子
啎	𠂉 十 一 口
問	門 口
啑	口 一 彐 龰
啒	口 尸 屮 凵
啓	户 夊 口
啔	户 戈 口
啗	口 冖 臼
啘	口 宀 夕 㔾
啙	止 匕 口 口
啚	口 十 囗 口
啛	口 十 彐 女
啝	口 禾 口
啞	口 一 {亞下}
啟	户 口 夊
啠	斤 斤 口
啢	口 一 巾 入
啣	口 𠂉 一 卩
啨	口 龶 月
啩	口 土 土 卜
啫	口 耂 日
啯	口 囗 王 丶
啰	口 罒 夕
啱	口 山 石
啲	口 白 勹 丶
啳	口 丷 夫 㔾
啴	口 丷 日 十
啹	口 尸 古
啺	口 日 一 {两撇}
啽	口 合 卄
啿	口 其 乚
喅	口 日 立
喆	士 口 士 口
喌	口 口 ⺍ 川
喍	口 止 匕 木
喎	口 咼
喐	口 {左上} 月 阝
喒	口 夊 卜 日
喓	口 西 女
喕	口 面
喖	口 木 古
喗	口 冖 車
喚	口 冖 冂 大
喛	口 爪 干 又
喞	口 白 匕 卩
喠	口 千 里
喡	口 韋
喢	口 千 臼
喣	口 勹 口 灬
喤	口 白 王
喥	口 广 卄 又
喦	口 口 口 山
喨	口 {亮頭} 几
喩	口 入 一 巜
喪	十 口 口 {畏下}
喫	口 丰 刀 大
喬	夭 口 冂 口
喭	口 立 丿 彡
單	口 口 日 十
喯	口 大 十 卄
喰	口 食
喲	口 糹 勹 丶
喴	口 戊 一 女
営	⺍ 冖 口 口
喸	甫 口 匕
喺	口 亻 丿 糸
喼	口 冖 彐 心
喿	口 口 口 木
嗀	{穀頭} 一 口
嗁	口 ⺁ 虎
嗂	口 爪 缶
嗃	口 高
嗆	口 人 丶 口
嗇	土 人 人 口
嗈	口 巛 口 巴
嗊	口 工 貝
嗋	口 力 力 月
嗎	口 馬
嗏	口 艹 人 木
嗐	口 宀 丰 口
嗕	口 辰 寸
嗗	口 骨
嗘	口 爪 幺 大
嗙	口 亠 丷 方
嗚	口 烏
嗛	口 䒑 彐 八
嗞	口 䒑 幺 幺
嗠	爪 子 夊 口
嗢	口 日 皿
嗧	力 口 人 冊
嗩	口 小 貝
嗭	十 且 口 匕
嗮	口 日 西
嗰	口 亻 囗 古
嗱	口 合 手
嗴	口 羊 乚 厶
嗶	口 日 卄 キ
嗸	龶 勹 夊 口
嗹	口 車 辶
嗺	口 山 隹
嗻	口 广 卄 灬
嗼	口 艹 日 大
嗿	口 人 丶 貝
嘂	口 口 丩 口
嘃	口 广 肀 月
嘄	口 {鳥上} 木
嘅	口 彐 厶 儿
嘆	口 卄 一 夫
嘇	口 厶 厶 彡
嘊	口 山 厂 土
嘋	口 耂 子 夊
嘍	口 口 十 女
嘐	口 习 习 彡
嘑	口 {虎头} 丿 {于下}
嘒	口 丰 丰 彐
嘓	口 囗 戈 一
嘔	口 匚 口 口
嘕	口 一 止 灬
嘖	口 龶 貝
嘗	尚 匕 日
嘙	口 氵 皮 女
嘚	口 彳 日 寸
嘜	口 來 夊
嘝	口 冖 用 十
嘠	口 丆 月 戈
嘡	口 尚 土
嘢	口 里 予
嘥	口 彳 止 龰
嘦	口 八 西 女
嘨	口 彐 米 {介下}
嘩	口 艹 干 龷
嘪	口 罒 貝
嘫	口 月 犬 灬
嘮	口 火 火 力
嘯	口 肀 片 一
嘰	口 幺 幺 人
嘳	口 口 丄 貝
嘵	口 土 土 兀
嘷	口 自 二 十
嘸	口 𠂉 卌 灬
嘺	口 夭 口 口
嘼	口 口 田 口
嘽	口 口 口 十
嘾	口 西 早
噀	口 巳 巳 八
噁	口 一 {亞下} 心
噂	口 丷 酉 寸
噃	口 丿 米 田
噄	口 丰 刀 糸
噅	口 爪 {爲下}
噆	口 匚 儿 日
噇	口 立 里
噈	口 {京頭} 小 尤
噉	口 乛 耳 夊
噊	口 予 丿 口
噋	口 {京頭} 子 夊
噏	口 合 习 习
噐	口 口 工 口
噑	口 白 二 十
噒	口 米 夕 ヰ
噓	口 {虎头} 丱 一
噕	爪 {爲下} 口
噖	口 王 王 乛
噚	口 彐 工 寸
噛	口 止 米 凵
噝	口 糹 糸
噞	口 僉
噟	广 亻 隹 口
噠	口 土 羊 辶
噡	口 冖 厂 言
噣	口 罒 勹 虫
噥	口 冂 龷 辰
噦	口 止 戊 小
噧	口 艹 禺
噭	口 白 方 夊
噮	口 罒 一 𧘇
噯	口 爪 冖 夊
噰	口 亠 {纟上} 隹
噲	口 人 一 日
噳	口 {虎头} 口 大
噴	口 十 卄 貝
噵	䒑 自 辶 口
噷	口 立 日 欠
噸	口 七 凵 貝
噹	口 尚 田
噺	口 立 木 斤
噽	士 口 䒑 一
噾	口 穴 立 日
噿	口 习 习 十
嚀	口 宀 心 丁
嚁	口 习 习 隹
嚂	口 臣 {⺮右} 皿
嚃	口 罒 水 辶
嚄	口 艹 隹 又
嚇	口 土 {介下} 八
嚈	口 厂 日 犬
嚉	口 业 羊 寸
嚊	口 自 田 丌
嚋	口 士 乛 寸
嚌	口 亠 丷 二
嚍	口 肀 一 皿
嚐	口 尚 匕 日
嚑	口 千 黑
嚒	口 麻 幺
嚔	口 十 冖 龰
嚕	口 魚 日
嚖	口 丰 丰 心
嚗	口 日 龷 水
嚘	口 丆 月 夊
嚙	口 齒
嚚	口 口 臣 口
嚛	口 白 幺 木
嚜	口 黑 土
嚝	口 广 龷 八
嚞	士 口 士 口
嚟	口 禾 勹 水
嚠	口 卯 金 刂
嚡	口 革 土 土
嚢	十 口 冖 𧘇
嚤	口 麻 手
嚥	口 卄 一 灬
嚦	口 厂 禾 止
嚧	口 {虎头} 田 皿
嚨	口 立 月 {龍右}
嚩	口 糹 甫 寸
嚪	口 門 冖 臼
嚫	口 立 木 見
嚬	口 止 小 貝
嚭	士 口 䒑 口
嚮	{纟上} 丿 丶 向
嚰	口 麻 石
嚱	口 {虎头} 一 戈
嚲	{京頭} 子 口 十
嚳	臼 乂 乂 口
嚴	口 口 厂 夊
嚵	口 冖 口 丶
嚶	口 貝 貝 女
嚸	口 黑 卜 口
嚹	口 缶 {虎头} {于下}
嚺	口 罒 䒑 辶
嚻	口 口 丆 口
嚽	口 龶 勹 貝
嚾	口 艹 口 隹
嚿	口 艹 隹 臼
囀	口 車 {專上} 寸
囁	口 耳 耳 耳
囂	口 口 丆 口
囃	口 亠 人 隹
囄	口 文 凵 隹
囅	口 口 日 {畏下}
囆	口 艹 禺 虫
囇	口 一 {冂丶} 鹿
囈	口 艹 土 厶
囉	口 罒 糹 隹
囋	口 ⺧ 儿 貝
囌	口 艹 魚 禾
囍	士 口 䒑 口
囎	口 貝 丷 日
囏	卄 一 口 口
囐	口 {虎头} 一 犬
囑	口 尸 水 虫
囒	口 艹 門 丷
囓	口 丰 刀 齒
囕	口 臣 {⺮右} 見
囖	口 竹 罒 隹
囘	冂 巳
囙	囗 コ
囜	囗 厶
団	囗 寸
囥	囗 亠 几
囦	囗 水
囧	囗 八 冂
囨	囗 不
囩	囗 二 厶
囪	{囟框} {两撇} 丶
囬	囗 〢 二
囮	囗 亻 匕
囯	囗 王
囲	囗 二 {介下}
図	囗 ⺀ 乂
囶	囗 八 土
囷	囗 禾
囸	囗 一 止
囻	囗 巳 七
囼	囗 厶 口
圀	囗 八 方
圁	囗 言
圂	囗 豕
圅	マ 囗 䒑 十
圇	囗 人 一 冊
國	囗 戈 口 一
圌	囗 山 而
圍	囗 韋
圎	囗 厶 貝
圏	囗 丷 夫 己
圐	囗 罒 方
圑	囗 甫 寸
園	囗 土 口 𧘇
圓	囗 口 貝
圔	囗 土 厶 皿
圕	囗 彐 土 日
圖	囗 口 十 口
圗	囗 厶 十 二
團	囗 {專上} 寸
圙	囗 八 面
圚	囗 口 丄 貝
圛	囗 罒 土 十
圝	囗 言 糹 糹
圞	囗 言 糹 木
圠	土 乚
圡	土 丶
圢	土 丁
圤	土 卜
圥	土 儿
圦	土 入
圧	厂 土
圫	土 丿 七
圱	千 土
圲	土 千
圴	土 勹 丶
圵	土 上
圶	大 土
圷	土 下
圸	土 山
圼	日 土
圽	土 勹 {两撇}
圿	土 人 {介下}
坁	土 {卬左} 七
坃	土 一 兀
坄	土 殳
坅	土 人 丶 乛
坆	土 夊
坈	土 冖 几
坉	土 七 凵
坋	土 八 刀
坒	匕 匕 土
坓	二 {介下} 土
坔	水 土
坕	爪 土
坖	一 兀 土
坘	土 一 彑
坙	一 巛 土
坢	土 丷 キ
坣	龸 土
坥	土 且
坧	土 石
坬	土 瓜
坮	土 厶 口
坰	土 冂 口
坱	土 冂 大
坲	土 弓 {介下}
坴	土 八 土
坵	土 斤 一
坸	土 勹 口
坹	土 穴
坺	土 {左上} 又 丶
坽	土 人 丶 マ
坾	土 宀 丁
坿	土 亻 寸
垀	土 丿 丷 {于下}
垁	土 矢
垇	土 {雋下} 一
垈	亻 弋 土
垉	土 勹 巳
垊	土 巳 七
垍	土 自
垎	土 夊 口
垏	土 彐 キ
垐	二 欠 土
垑	土 夕 夕
垔	西 土
垕	⺁ 一 口 土
垖	土 𠂤
垗	土 儿 二 二
垘	土 亻 犬
垙	土 小 兀
垚	土 土 土
垜	土 乃 木
垝	土 冖 厂 㔾
垞	土 宀 丿 七
垟	土 羊
垥	土 合
垨	土 宀 寸
垪	土 䒑 卄
垬	土 龷 八
垯	土 大 辶
垰	土 上 下
垱	土 小 彐
垳	土 彳 亍
垵	土 宀 女
垶	土 辛
垷	土 見
垹	土 丰 阝
垺	土 爪 子
垻	土 貝
垼	彳 殳 土
垽	氵 斤 土
垾	土 日 干
垿	土 广 予
埀	千 丬 匕 二
埁	土 山 人 乛
埄	土 夊 丰
埅	阝 方 土
埆	土 冖 用
埇	土 マ 用
埈	土 厶 八 夊
埉	土 大 人 人
埊	山 水 土
埌	土 丶 艮
埍	土 口 月
埐	土 彐 冖 又
埑	扌 斤 土
埓	土 爪 寸
埖	土 艹 亻 匕
埗	土 止 小
埛	土 冂 八 口
埜	木 木 土
埞	土 宀 一 龰
埡	土 一 {亞下}
埢	土 丷 夫 㔾
埣	土 亠 人 十
埥	土 龶 月
埦	土 宀 夕 㔾
埧	土 且 八
埨	土 人 一 冊
埩	土 冖 彐 亅
埪	土 穴 工
埫	土 尚
埬	土 木 日
埮	土 火 火
埰	土 爪 木
埱	土 上 小 又
埲	土 𡗗 キ
埳	土 冖 臼
埵	土 壬 龷
埶	土 八 土 丶
執	土 䒑 十 丶
埻	土 {京頭} 子
埼	土 大 丁 口
埾	耳 又 土
埿	氵 尸 匕 土
堁	土 日 木
堃	方 方 土
堄	土 臼 儿
堅	臣 又 土
堈	土 冂 䒑 山
堉	土 亠 厶 月
堊	一 {亞下} 土
堌	土 囗 古
堎	土 土 八 夊
堏	木 方 土
堐	土 厂 土 土
堒	土 日 匕 匕
堓	土 山 厂 干
堔	土 冖 八 木
堖	土 巛 {囟框} 乂
堗	土 穴 犬
堘	土 丷 夫 土
堚	土 冖 車
堛	土 一 口 田
堜	土 木 囗 丷
堝	土 咼
堟	土 {互中} 豕
堢	土 亻 口 木
堣	土 禺
堥	予 丿 夊 土
堦	土 匕 匕 白
堧	土 而 大
堨	土 日 勹 乚
堩	土 忄 一 一
堫	土 乂 凵 夊
堬	土 人 一 刂
堭	土 白 王
堮	土 口 口 丂
堯	土 土 土 兀
報	土 䒑 十 又
堲	彐 厶 卩 土
堳	土 {眉上} 目
場	土 日 一 {两撇}
堶	土 {左上} 工 月
堷	土 立 日
堸	土 風
堹	土 千 里
堺	土 田 人 {介下}
堻	氵 彐 キ 土
堼	土 土 寸 土
堽	土 罒 一 止
堾	土 𡗗 日
堿	土 戊 一 口
塀	土 尸 䒑 卄
塁	田 二 二 土
塂	土 龷 八 巳
塃	土 艹 亡 {荒下}
塅	土 亻 三 殳
塆	土 亦 弓
塇	土 宀 一 一
塈	彐 厶 匚 土
塉	土 二 二 月
塊	土 鬼
塋	火 火 冖 土
塎	土 穴 人 口
塏	土 山 一 䒑
塐	土 龶 糸
塒	土 日 土 寸
塓	土 冖 日 八
塕	土 八 厶 习
塖	土 禾 丬 匕
塗	氵 人 一 土
塙	土 高
塚	土 冖 豕 丶
塛	土 西 木
塜	土 冖 一 豕
塝	土 亠 丷 方
塟	艹 一 夕 土
塠	土 𠂤 辶
塡	土 匕 目 八
塢	土 烏
塣	氵 口 王 土
塤	土 口 貝
塦	阝 車 土
塧	土 䒑 八 皿
塨	土 龷 八 丶
塩	土 𠂉 口 皿
塪	土 爪 臼
塭	土 日 皿
塮	土 身 寸
塯	土 卯 田
塰	氵 𠂉 母 土
塱	丶 彐 厶 土
塲	土 𠂉 日 {两撇}
塳	土 夊 丰 辶
塴	土 山 月 月
塵	鹿 土
塶	土 鹿
塷	土 鹵
塸	土 匚 口 口
塹	車 斤 土
塺	麻 土
塻	土 艹 日 大
塼	土 {專上} 寸
塽	土 大 乂 乂
塿	土 口 十 女
墂	土 西 示
墄	土 戊 上 小
墆	土 卌 一 巾
墇	土 立 早
墈	土 其 乚 力
墊	土 䒑 十 土
墋	土 厶 厶 彡
墌	土 广 卄 灬
墍	白 匕 匚 土
墎	土 {京頭} 子 阝
墏	爿 月 寸 土
墐	土 革 二
墑	土 亠 丷 古
墔	土 山 隹
墕	土 一 止 灬
墖	土 合 田
増	土 丷 田 日
墘	土 十 早 乙
墛	土 尸 示 寸
墜	阝 䒑 豕 土
墝	土 土 土 兀
墠	土 口 口 十
墡	土 羊 䒑 口
墢	土 癶 弓 殳
墣	土 业 䒑 夫
墤	土 口 丄 貝
墥	土 立 里
墦	土 丿 米 田
墧	土 夭 口 口
墪	{京頭} 子 夊 土
墫	土 丷 酉 寸
墬	阝 {互中} 豕 土
墭	土 戊 乛 皿
墮	阝 {左上} 工 土
墯	忄 {左上} 工 土
墰	土 西 早
墱	土 癶 一 䒑
墲	土 𠂉 卌 灬
墳	土 十 卄 貝
墴	土 龷 由 八
墵	土 雨 二 厶
墶	土 土 羊 辶
墷	土 艹 干 龷
墸	土 艹 耂 日
墹	土 門 日
墺	土 {向框} 米 大
墻	土 土 人 口
墽	土 白 方 夊
墾	豸 艮 土
墿	土 罒 土 十
壀	土 尸 口 辛
壂	尸 龷 八 土
壃	土 一 田 一
壄	木 予 丿 土
壆	臼 乂 乂 土
壇	土 亠 囗 一
壈	土 亠 囗 禾
壉	土 {虎头} 豕
壊	土 十 罒 𧘇
壋	土 尚 田
壌	土 亠 八 𧘇
壍	氵 車 斤 土
壎	土 千 黑
壏	土 臣 {⺮右} 皿
壐	一 八 巾 土
壒	土 艹 土 皿
壓	厂 日 月 土
壔	土 士 乛 寸
壖	土 雨 而
壗	土 肀 一 皿
壘	田 田 田 土
壙	土 广 龷 八
壚	土 {虎头} 田 皿
壛	土 門 冖 臼
壜	土 日 雨 厶
壝	土 口 丄 辶
壞	土 亠 罒 𧘇
壟	立 月 {龍右} 土
壠	土 立 月 {龍右}
壡	卜 冖 一 土
壢	土 厂 禾 止
壣	土 耳 幺 丱
壥	土 厂 黑 土
壦	土 艹 口 隹
壧	土 口 口 夊
壨	田 田 田 土
壩	土 雨 革 月
壪	土 言 糹 弓
壭	士 卩
壯	爿 士
壱	士 冖 匕
売	士 冖 儿
壴	士 口 䒑
壵	士 士 士
壷	士 冖 口 一
壸	士 冖 丌 䒑
壺	士 冖 {亞下}
壻	土 乛 龰 月
壼	士 冖 一 {亞下}
壽	士 乛 工 寸
壾	士 口 䒑 コ
壿	士 丷 酉 寸
夀	龶 乛 口 寸
夁	士 罒 囗 古
夃	乃 又
夅	夊 ヰ
夆	夊 丰
夈	夊 米
変	亦 夊
夊	夊
夋	厶 八 夊
夌	土 八 夊
夎	人 人 土 夊
夐	冖 冂 人 夊
夑	言 火 火 夊
夒	丆 目 止 夊
夓	丆 目 臼 夊
夗	夕 㔾
夘	夕 卩
夛	彐 夕
夝	夕 生
夞	夕 卜 口 匕
夠	夕 夕 勹 口
夡	夕 夕 士 口
夢	艹 罒 冖 夕
夣	亠 厶 罒 夕
夦	其 乚 夕 夕
夨	乚 大
夬	コ 人
夰	大 {介下}
夲	大 十
夳	大 二
夵	大 小
夶	大 大
夻	大 口
夽	大 二 厶
夾	大 人 人
夿	大 巴
奀	不 大
奃	大 {卬左} 七 丶
奅	大 卯
奆	大 匚 コ
奊	土 土 乚 大
奌	卜 口 大
奍	丷 夫 {介下}
奐	冖 冂 八 大
奒	大 亥
奓	大 夕 夕
奙	厶 大 电
奛	大 日 月
奜	非 大
奝	大 ⺆ 土 口
奞	大 隹
奟	大 月 月
奡	丆 目 大 {介下}
奣	一 大 日 月
奤	大 面
奦	予 丿 夊 大
奧	{向框} 丿 米 大
奨	丬 爪 寸 大
奩	大 匚 口 口
奪	大 隹 寸
奫	大 氵 片 一
奬	爿 月 寸 大
奭	大 丆 日 日
奮	大 隹 田
奯	大 止 戊 小
奰	罒 罒 罒 大
奱	言 糹 糹 大
奲	大 耂 日 十
奵	女 丁
奷	女 千
奺	女 冖 丶
奻	女 女
奼	女 丿 七
奾	女 山
奿	九 丶 女
妀	己 女
妅	女 工
妉	女 冖 儿
妋	女 夫
妌	女 二 {介下}
妎	女 人 {介下}
妏	女 文
妐	女 八 厶
妑	女 巴
妔	女 亠 几
妕	女 口 丨
妘	女 二 厶
妚	女 不
妛	屮 一 女
妜	女 コ 人
妝	爿 女
妟	日 女
妠	女 冂 人
妡	女 斤
妢	女 八 刀
妦	女 丰
妧	女 一 兀
妬	女 石
妭	女 {左上} 又 丶
妰	女 𠂉 {乍下}
妱	女 刀 口
妳	女 冖 小
妴	夕 㔾 女
妵	女 丶 王
妶	女 亠 幺
妷	女 丿 夫
妸	女 丁 口
妺	女 末
妼	女 心 丿
妽	女 申
妿	力 口 女
姀	女 禾
姁	女 勹 口
姂	女 丿 之
姃	女 一 止
姄	女 巳 七
姅	女 丷 キ
姇	亻 寸 女
姈	女 人 丶 マ
姉	女 一 巾
姌	女 冂 土
姍	女 冊
姎	女 冂 大
姏	女 卄 二
姕	止 匕 女
姖	女 匚 コ
姙	女 亻 壬
姛	女 冂 一 口
姞	女 士 口
姟	女 亥
姠	女 向
姡	女 舌
姢	女 厶 月
姤	女 ⺁ 一 口
姦	女 女 女
姧	女 女 干
姩	女 𠂉 ヰ
姪	女 至
姫	女 臣
姭	力 力 力 女
姮	女 一 日 一
姯	女 小 兀
姰	女 勹 日
姱	女 大 一 丂
姲	女 宀 女
姳	女 夕 口
姴	一 夕 刂 女
姵	女 几 一 巾
姶	女 合
姷	女 {左上} 月
姸	女 干 干
姺	女 ⺧ 儿
姼	女 夕 夕
姽	女 冖 厂 㔾
姾	女 人 王
娀	女 戈 {左上}
娂	女 龷 八
娊	女 見
娋	女 小 月
娍	女 戊 乛
娎	扌 斤 女
娏	女 尤 彡
娐	女 爪 子
娒	女 𠂉 母
娔	女 古 儿
娕	女 木 口
娖	女 足
娗	女 壬 廴
娙	女 一 巛 工
娚	女 田 力
娛	女 口 ㇉ 大
娝	女 不 口
娞	女 爪 女
娡	女 士 心
娢	女 人 丶 口
娤	爿 士 女
娦	女 斤 一 八
娧	女 丷 口 儿
娨	女 日 干
娪	女 一 {五下} 口
娫	女 丿 止 廴
娬	女 一 弋 止
娭	女 厶 矢
娮	女 言
娯	女 口 ㇉ 八
娰	女 亻 乚 人
娳	女 禾 刂
娵	女 耳 又
娷	女 壬 龷
娸	女 其
娹	女 弓 亠 幺
娺	女 又 又 又
娻	女 木 日
娽	女 彐 水
娾	女 厂 土 土
娿	阝 丁 口 女
婁	口 十 口 女
婂	女 白 巾
婃	女 宀 示
婄	女 立 口
婅	女 勹 米
婇	女 爪 木
婈	女 土 八 夊
婋	女 虎
婌	女 上 小 又
婍	女 大 丁 口
婎	女 隹
婏	女 冖 口 丶
婐	女 日 木
婑	女 禾 女
婒	女 火 火
婓	非 女
婔	女 非
婖	女 一 大 丶
婗	女 臼 儿
婘	女 丷 夫 㔾
婙	女 冖 彐 亅
婛	女 {京頭} 小
婜	臣 又 女
婝	女 宀 一 龰
婞	女 土 䒑 十
婟	女 囗 古
婠	女 宀 尸 コ
婡	女 來
婣	女 片 爿 一
婤	女 ⺆ 土 口
婥	女 卜 早
婦	女 彐 冖 巾
婨	女 人 一 冊
婩	女 山 厂 干
婫	女 日 匕 匕
婬	女 爪 壬
婭	女 一 {亞下}
婮	女 尸 古
婯	一 {冂丶} 一 女
婰	女 冂 龷 八
婱	弓 亠 幺 女
婲	女 艹 亻 匕
婳	女 一 田 凵
婸	女 日 一 {两撇}
婹	女 西 女
婻	女 十 冂 十
婼	女 艹 {左上} 口
婽	女 尸 二 又
婾	女 入 一 巜
媀	女 禺
媁	女 韋
媂	女 亠 丷 巾
媃	女 予 丿 木
媄	女 羊 大
媅	女 其 乚
媆	女 而 大
媇	女 立 木
媈	女 冖 車
媉	女 尸 至
媊	女 䒑 月 刂
媋	女 𡗗 日
媌	女 艹 田
媍	女 冖 貝
媎	女 耂 日
媏	女 山 而
媐	臣 巳 女
媑	女 千 里
媓	女 白 王
媔	女 面
媕	女 合 卄
媖	女 艹 冂 大
媗	女 宀 一 一
媘	女 匕 匕 白
媙	女 戊 一 女
媜	女 卜 貝
媝	禾 火 女
媞	女 日 一 龰
媟	女 世 木
媠	女 {左上} 工 月
媡	女 木 囗 丷
媢	女 冂 二 目
媣	女 氵 九 木
媤	女 田 心
媥	女 户 冊
媦	女 田 月
媧	女 咼
媨	女 丷 酉
媩	女 古 月
媫	女 卜 彐 龰
媬	女 亻 口 木
媭	彡 丆 贝 女
媮	女 人 一 刂
媯	女 丶 {爲下}
媰	女 勹 屮 屮
媱	女 爪 缶
媴	女 土 口 𧘇
媶	女 艹 耳
媷	女 辰 寸
媹	女 卯 田
媺	女 山 一 夊
媻	舟 殳 女
媼	女 囗 人 皿
媽	女 馬
媿	女 鬼
嫀	女 𡗗 禾
嫃	女 十 且 八
嫄	女 厂 白 小
嫅	女 羊 工
嫆	女 穴 人 口
嫇	女 冖 日 八
嫈	火 火 冖 女
嫊	女 龶 糸
嫋	女 弓 二 二
嫍	女 爪 臼
嫎	女 亠 丷 方
嫏	女 丶 彐 阝
嫐	女 田 力 女
嫑	不 西 女
嫓	女 冖 冂 匕
嫕	女 匚 矢 心
嫗	女 匚 口 口
嫙	女 方 𠂉 龰
嫚	女 日 罒 又
嫛	匚 矢 殳 女
嫝	女 广 彐 水
嫞	女 广 肀 月
嫟	女 匚 艹 口
嫢	夫 見 女
嫤	女 革 二
嫥	女 {專上} 寸
嫧	女 龶 貝
嫨	女 卄 一 夫
嫪	女 习 习 彡
嫬	女 广 卄 灬
嫭	女 {虎头} 丿 {于下}
嫮	女 雨 一 丂
嫯	龶 勹 夊 女
嫰	女 木 口 欠
嫲	女 麻
嫳	丷 巾 八 女
嫴	女 古 辛
嫵	女 𠂉 卌 灬
嫶	女 隹 灬
嫷	女 阝 {左上} 月
嫸	女 羊 䒑 口
嫹	女 龷 由 八
嫺	女 門 月
嫻	女 門 木
嫼	女 黑
嫽	女 大 丷 小
嫾	女 米 夕 ヰ
嫿	女 彐 土 一
嬀	女 爪 {爲下}
嬁	女 癶 一 䒑
嬂	女 立 日 戈
嬃	彡 丆 貝 女
嬄	女 士 冖 䒑
嬅	女 艹 干 龷
嬆	女 合 习 习
嬇	女 口 丄 貝
嬈	女 土 土 兀
嬊	卄 一 口 女
嬋	女 口 口 十
嬌	女 夭 口 口
嬍	女 山 一 夊
嬎	女 冖 口 生
嬏	女 丿 米 田
嬐	女 僉
嬑	女 立 日 心
嬒	女 人 一 日
嬓	女 白 方 夊
嬔	女 冖 口 生
嬕	女 罒 土 十
嬘	女 䒑 豕 辶
嬙	女 土 人 口
嬚	女 广 䒑 八
嬛	女 罒 一 𧘇
嬜	立 日 欠 女
嬝	女 {鳥上} 亠 𧘇
嬞	女 艹 千 里
嬟	女 羊 丿 戈
嬠	女 口 口 木
嬡	女 爪 冖 夊
嬢	女 亠 八 𧘇
嬣	女 宀 心 丁
嬤	女 麻 幺
嬥	女 习 习 隹
嬦	女 士 乛 寸
嬧	女 肀 一 皿
嬨	女 䒑 幺 心
嬩	女 臼 丂 八
嬪	女 宀 一 貝
嬫	女 火 火 木
嬬	女 雨 而
嬭	女 一 八 乂
嬮	厂 日 月 女
嬯	女 士 口 至
嬰	貝 貝 女
嬱	氵 車 斤 女
嬳	女 艹 隹 又
嬵	女 糹 白 巾
嬶	女 自 田 丌
嬸	女 宀 丿 田
嬹	女 臼 冂 八
嬺	女 匚 艹 心
嬻	女 士 罒 貝
嬼	女 卯 金 刂
嬽	女 罒 丨 大
嬾	女 木 口 貝
嬿	女 卄 一 灬
孁	雨 口 口 女
孂	女 竹 艮 皿
孃	女 {京頭} 口 𧘇
孄	女 門 木 丷
孅	女 人 人 一
孆	女 貝 貝 女
孇	女 隹 隹 又
孈	女 山 隹 口
孉	女 艹 口 隹
孊	女 麻 非
孋	女 一 {冂丶} 鹿
孌	言 糹 糹 女
孍	女 口 口 夊
孎	女 尸 水 虫
孏	女 艹 門 丷
孒	了 一
孖	子 子
孞	子 心
孠	乛 一 口 子
孡	子 厶 口
孧	幺 力 子
孨	子 子 子
孫	子 丿 糸
孭	子 貝
孮	子 宀 示
孯	臣 又 子
孲	子 一 {亞下}
孴	子 子 子 日
孶	艹 幺 幺 子
孷	未 夊 厂 子
學	臼 乂 乂 子
孹	尸 口 辛 子
孻	子 肀 一 皿
孼	屮 𠂤 辛 子
孾	子 貝 貝 女
孿	言 糹 糹 子
宂	宀 几
宆	宀 弓
宊	宀 犬
宍	宀 亠 八
宎	宀 夭
宐	宀 夕 一
宑	宀 二 {介下}
宒	宀 毛
宔	宀 丶 王
宖	宀 弓 厶
実	宀 𡗗
宧	宀 臣
宨	宀 儿 二 二
宩	宀 米
宬	宀 戊 乛
宭	宀 彐 丿 口
宮	宀 口 {囟框}
宯	宀 耂 子
宱	宀 亻 𠂉 {乍下}
宲	宀 口 木
宷	宀 丿 米
宺	宀 口 丅 儿
宻	宀 又 丷 山
宼	宀 一 兀 女
寀	宀 爪 木
寁	宀 一 彐 龰
寃	宀 冖 口 丶
寈	宀 龶 月
寉	宀 隹
寊	宀 卜 貝
寋	宀 {冓上} 八 㔾
寍	宀 心 皿
寎	宀 爿 一 人
寏	宀 冖 冂 大
寑	宀 亻 彐 又
寔	宀 日 一 龰
寕	宀 丆 罒 丁
寖	宀 氵 彐 又
寗	宀 心 丿 土
寘	宀 十 且 八
寙	宀 瓜 瓜
寚	宀 王 缶
寛	宀 艹 見
寜	宀 心 皿 亅
寠	宀 口 十 女
寢	宀 爿 彐 又
寣	宀 爿 言
實	宀 {母框} 十 貝
寧	宀 心 皿 丁
審	宀 丿 米 田
寪	宀 爪 {爲下}
寫	宀 臼 勹 灬
寬	宀 艹 見 丶
寭	宀 {專上} 心
寯	宀 隹 {雋下}
寱	宀 爿 自 木
寲	宀 匕 矢 龰
寳	宀 王 冖 貝
寴	宀 立 木 見
寵	宀 立 月 {龍右}
寶	宀 王 缶 貝
寷	宀 山 丰 䒑
寽	爪 寸
対	文 寸
尀	匚 口 寸
専	一 由 寸
尃	甫 寸
尅	古 儿 寸
將	爿 月 寸
專	{專上} 寸
尋	彐 工 口 寸
尌	士 口 䒑 寸
對	业 羊 寸
導	䒑 自 辶 寸
尐	小 乀
尒	人 小
尓	𠂉 小
尗	上 小
尙	尚
尛	小 小 小
尞	大 丷 日 小
尟	日 一 龰 丿
尠	其 乚 小 丿
尡	小 兀 日 匕
尣	八 儿
尦	八 儿 勹 丶
尨	尤 彡
尩	八 儿 王
尪	尢 王
尫	兀 王
尭	十 卄 兀
尮	尢 乃 木
尯	尢 冖 厂 㔾
尰	尢 千 里
尲	尢 䒑 彐 八
尳	尢 骨
尵	尢 口 丄 貝
尶	兀 臣 {⺮右} 皿
尷	尢 臣 {⺮右} 皿
屃	尸 贝
屄	尸 穴
屆	尸 土 凵
屇	尸 田
屌	尸 口 巾
屍	尸 一 夕 匕
屒	尸 辰
屓	尸 貝
屔	斤 一 尸 匕
屖	尸 辛
屗	尸 毛 寸
屘	尸 毛 子
屚	尸 雨
屛	尸 丿 干 干
屜	尸 彳 世
屝	尸 非
屟	尸 世 木
屢	尸 口 十 女
層	尸 丷 日 日
屧	尸 彳 世 木
屨	尸 彳 口 女
屩	尸 彳 夭 口
屪	尸 宀 大 小
屫	尸 爿 夭 口
屬	尸 水 罒 虫
屭	尸 貝 貝 貝
屰	䒑 屮
屲	丿 山
屳	入 山
屴	山 力
屵	山 厂
屶	山 刀
屷	山 乃
屸	山 工
屻	山 刀 丶
屼	山 兀
屽	山 干
屾	山 山
岀	山 山
岃	山 刀 丶
岄	山 月
岅	山 ⺁ 又
岆	山 夭
岇	山 {卬左} 卩
岉	山 勹 {两撇}
岊	巴 山
岋	山 乃 乀
岎	山 八 刀
岏	山 一 兀
岒	山 人 丶 乛
岓	山 斤
岕	山 人 {介下}
岝	山 𠂉 {乍下}
岞	山 𠂉 {乍下}
岟	山 冂 大
岠	山 匚 コ
岡	冂 䒑 山
岤	山 穴
岥	山 皮
岦	山 立
岧	山 刀 口
岨	山 且
岪	山 弓 {介下}
岮	山 宀 匕
岯	山 不 一
岰	山 幺 力
岲	山 口 儿
岴	山 斤 一
岶	山 白
岹	山 刀 口
岺	山 人 丶 マ
岻	山 {卬左} 七 丶
岼	山 干 丷
岾	山 卜 口
峀	山 由
峂	山 夊 ⺀
峃	⺍ 冖 山
峅	山 厶 卄
峆	山 合
峇	山 合
峈	山 夊 口
峉	山 夊 口
峊	𠂤 山
峌	山 至
峍	山 彐 キ
峎	山 艮
峏	山 而
峐	山 亥
峑	山 人 王
峓	山 大 弓
峔	山 耂 匕
峕	山 亠 日
峖	山 宀 女
峗	山 冖 厂 㔾
峘	山 一 日 一
峚	山 大 土
峛	山 一 夕 刂
峜	山 人 止
峝	山 冂 一 口
峞	山 冖 厂 㔾
峟	山 {左上} 月
峠	山 上 下
峢	山 一 夕 刂
峣	山 七 丿 兀
峧	山 亠 八 乂
峩	山 丿 扌 戈
峫	山 牙 阝
峬	山 甫
峮	山 彐 丿 口
峯	山 夊 丰
峱	犭 丑 山
峲	山 禾 刂
峳	山 亻 丨 夊
峴	山 見
峵	山 宀 {左上} 厶
島	{鳥上} 山
峷	山 辛
峸	山 戊 乛
峹	人 一 木 山
峺	山 一 日 乂
峼	山 ⺧ 口
峽	山 大 人 人
峾	氵 斤 山
峿	山 一 {五下} 口
崀	山 丶 艮
崁	山 土 欠
崄	山 人 一 {兴上}
崅	山 冖 用
崈	宀 示 山
崉	山 水 日
崊	山 木 木
崋	山 干 龷
崌	山 尸 古
崍	山 來
崏	山 {卬左} 七 日
崐	山 日 匕 匕
崑	山 日 匕 匕
崒	山 亠 人 十
崓	山 囗 古
崕	山 厂 土 土
崗	山 冂 䒑 山
崘	山 人 一 冊
崙	山 人 一 冊
崚	山 土 八 夊
崜	山 壬 龷
崝	山 龶 月
崟	山 金
崠	山 木 日
崡	山 乛 水 凵
崢	山 爪 彐 亅
崣	山 禾 女
崥	山 {卑上} 十
崨	山 一 彐 龰
崪	山 亠 人 十
崫	山 尸 屮 凵
崬	山 木 日
崯	山 金
崰	山 巛 田
崱	山 貝 刂
崲	山 白 王
崳	山 人 一 刂
崵	山 日 一 {两撇}
崶	山 土 土 寸
崷	山 丷 酉
崸	山 丆 貝
崹	山 亠 丷 巾
崺	山 方 𠂉 也
崻	山 彳 土 寸
崼	山 日 一 龰
崿	山 口 口 丂
嵀	山 木 丶 王
嵁	山 其 乚
嵂	山 彳 彐 キ
嵃	山 立 丿 彡
嵄	山 羊 大
嵅	山 戊 一 口
嵆	禾 尤 山
嵈	山 爪 干 又
嵉	山 {亮頭} 丁
嵍	予 丿 夊 山
嵎	山 禺
嵏	山 乂 凵 夊
嵐	山 風
嵑	山 日 勹 乚
嵒	口 口 口 山
嵓	山 口 口 口
嵔	山 田 {畏下}
嵕	山 乂 凵 夊
嵖	山 木 日 一
嵗	山 戊 一 小
嵙	山 禾 ⺀ 十
嵚	山 钅 欠
嵜	山 立 口 亅
嵞	人 一 木 山
嵟	山 厂 隹
嵠	山 爪 幺 大
嵡	山 八 厶 习
嵢	山 人 丶 口
嵣	山 广 肀 口
嵤	火 火 冖 山
嵥	山 夕 ヰ 木
嵦	山 山 一 䒑
嵧	山 卯 田
嵨	山 烏
嵪	山 高
嵭	山 亠 丷 方
嵮	山 十 且 八
嵰	山 䒑 彐 八
嵱	山 穴 人 口
嵲	山 自 木
嵳	山 羊 工
嵵	山 日 土 寸
嵶	山 弓 二 二
嵷	山 彳 人 龰
嵸	山 彳 人 龰
嵹	山 弓 口 虫
嵺	山 习 习 彡
嵻	山 广 彐 水
嵼	山 立 丿 生
嵽	山 卌 一 巾
嵾	山 厶 厶 彡
嵿	山 丁 丆 貝
嶀	山 雨 一 丂
嶁	山 口 十 女
嶃	山 車 斤
嶄	山 車 斤
嶅	龶 勹 夊 山
嶆	山 艹 日 日
嶇	山 匚 口 口
嶈	山 爿 月 寸
嶉	山 口 隹
嶊	山 扌 隹
嶋	山 鳥
嶌	山 鳥
嶍	山 习 习 白
嶎	山 尸 示 寸
嶏	山 厂 酉 己
嶐	山 阝 夊 生
嶑	山 冖 口 豕
嶒	山 丷 日 日
嶓	山 丿 米 田
嶔	山 金 欠
嶕	山 隹 灬
嶖	山 合 习 习
嶗	山 火 火 力
嶘	山 木 戈 戈
嶚	山 大 丷 小
嶛	山 大 丷 小
嶜	山 匚 儿 日
嶞	阝 {左上} 工 山
嶟	山 丷 酉 寸
嶠	山 夭 口 口
嶡	山 厂 䒑 欠
嶢	山 土 土 兀
嶣	山 隹 灬
嶤	山 土 土 兀
嶥	山 厂 䒑 欠
嶦	山 冖 厂 言
嶧	山 罒 土 十
嶨	臼 乂 乂 山
嶩	山 冂 龷 辰
嶪	山 业 羊 八
嶫	山 业 羊 八
嶬	山 羊 丿 戈
嶭	山 𠂤 辛
嶮	山 僉
嶯	山 口 耳 戈
嶰	山 冖 用 牛
嶱	山 艹 日 乚
嶲	山 隹 {雋下}
嶳	山 豕 土 土
嶴	{向框} 米 大 山
嶵	山 罒 非
嶶	山 {微上} 一 几
嶸	山 火 火 木
嶹	山 士 乛 寸
嶺	山 人 丶 貝
嶻	山 十 戈 隹
嶼	山 臼 丂 八
嶽	山 犭 言 犬
嶾	山 爪 工 心
嶿	山 雨 而
巀	山 小 隹 戈
巁	山 厂 艹 禺
巂	山 隹 冂 口
巃	山 立 月 {龍右}
巄	山 立 月 {龍右}
巆	山 火 火 口
巇	山 {虎头} 一 戈
巈	山 革 勹 米
巉	山 冖 口 丶
巊	山 貝 貝 女
巋	山 𠂤 止 巾
巌	山 ⺍ 厂 夊
巎	山 丆 目 夊
巏	山 艹 口 隹
巐	山 高 日 卄
巑	山 ⺧ 儿 貝
巒	言 糹 糹 山
巓	山 匕 目 貝
巔	山 十 且 貝
巕	山 䒑 𠂤 女
巖	山 口 口 夊
巗	山 口 口 夊
巘	山 {虎头} 一 犬
巙	山 䒑 自 夊
巚	山 {虎头} 一 犬
巜	巜
巟	亡 {荒下}
巠	一 巛 工
巣	⺍ 日 木
巤	巛 囗 乂 {鼠下}
巪	匚 コ 乛
巬	工 几 夫
巭	工 力 夫
巰	一 巛 工 {荒下}
巵	⺁ 一 巴
巶	刀 口 巳
巸	臣 巳
巹	乛 水 一 己
巺	巳 巳 一 八
巻	丷 夫 己
巼	巴 口 匕
巿	一 巾
帀	一 巾
帄	巾 丁
帇	彐 巾
帉	巾 八 刀
帊	巾 巴
帋	{卬左} 七 巾
帍	户 巾
帎	巾 冖 儿
帒	亻 弋 巾
帓	巾 末
帗	巾 {左上} 又 丶
帞	巾 丆 日
帟	亦 巾
帠	臼 巾
帡	巾 䒑 卄
帢	巾 合
帣	丷 夫 巾
帤	女 口 巾
帥	𠂤 巾
帨	巾 丷 口 儿
帩	巾 小 月
帪	巾 辰
師	𠂤 一 巾
帬	彐 丿 口 巾
帯	卅 一 冖 巾
帰	リ 彐 冖 巾
帲	巾 丿 干 干
帳	巾 長
帴	巾 戈 戈
帵	巾 宀 夕 㔾
帶	卌 一 冖 巾
帹	巾 立 女
帺	巾 其
帾	巾 耂 日
帿	巾 亻 コ 矢
幀	巾 卜 貝
幁	巾 丆 貝
幃	巾 韋
幆	巾 日 勹 乚
幇	土 土 寸 巾
幈	巾 尸 䒑 卄
幉	巾 世 木
幊	巾 工 貝
幋	舟 殳 巾
幍	巾 爪 臼
幎	巾 冖 日 八
幏	巾 宀 豕
幐	月 丷 夫 巾
幑	{微上} 一 巾
幒	巾 {囟框} 夊 心
幓	巾 厶 厶 彡
幖	巾 西 示
幗	巾 囗 戈 一
幘	巾 龶 貝
幙	巾 艹 日 大
幚	丰 阝 白 巾
幜	巾 日 {京頭} 小
幝	巾 口 口 十
幟	巾 立 日 戈
幠	巾 𠂉 卌 灬
幣	丷 巾 八 巾
幤	尚 夊 巾
幥	巾 尚 手
幦	尸 口 辛 巾
幧	巾 口 口 木
幨	巾 冖 厂 言
幩	巾 十 卄 貝
幪	巾 艹 冖 豕
幫	土 土 寸 巾
幬	巾 士 乛 寸
幭	巾 艹 罒 丶
幮	巾 广 士 寸
幯	巾 竹 彐 卩
幰	巾 宀 丰 心
幱	巾 門 木 丷
幵	干 干
幷	丿 干 丿 干
幹	十 早 人 干
幾	幺 幺 戈 人
庁	广 丁
庂	广 人
広	广 厶
庅	广 丿 厶
庈	广 人 丶 乛
庉	广 七 凵
庌	广 牙
庍	广 斤
庎	广 人 {介下}
庒	广 土 丶
庘	广 甲
庛	广 止 匕
庝	广 夊 ⺀
庡	广 亠 𧘇
庢	广 至
庣	广 儿 二 二
庤	广 土 寸
庨	广 耂 子
庩	广 人 一 木
庪	广 扌 十 又
庫	广 車
庬	广 尤 彡
庮	广 酉
庯	广 甫
庰	广 䒑 卄
庱	广 土 八 夊
庲	广 來
庴	广 龷 日
庺	广 八 厶 木
庻	广 卄 一 人
庼	广 匕 丆 贝
庽	广 禺
庿	广 艹 田
廀	广 宀 火 又
廁	广 貝 刂
廂	广 木 目
廃	广 癶 二 儿
廄	广 彐 厶 殳
廅	广 土 厶 皿
廆	广 鬼
廇	广 卯 田
廈	广 丆 目 夊
廋	广 臼 丨 又
廌	{鹿上} 丂 灬
廍	广 立 口 阝
廎	广 匕 丆 貝
廏	广 白 匕 殳
廐	广 彐 厶 儿
廔	广 口 十 女
廕	广 阝 人 厶
廗	广 卌 一 巾
廘	广 鹿
廙	广 田 龷 八
廚	广 士 口 寸
廜	广 尸 耂 日
廝	广 其 斤
廞	广 金 欠
廟	广 十 早 月
廠	广 尚 夊
廡	广 𠂉 卌 灬
廢	广 癶 弓 殳
廣	广 龷 由 八
廤	广 車 口 匕
廥	广 人 一 日
廦	广 尸 口 辛
廧	广 土 人 口
廩	广 亠 囗 禾
廫	广 月 习 彡
廬	广 {虎头} 田 皿
廭	广 禾 龶 貝
廮	广 貝 貝 女
廯	广 魚 羊
廰	广 耳 十 心
廱	广 巛 口 隹
廲	广 一 {冂丶} 鹿
廳	广 耳 王 心
廵	巛 廴
廸	由 廴
廹	白 廴
廻	囗 口 廴
廼	西 廴
廽	囗 〢 二 廴
弅	八 刀 卄
弆	土 厶 卄
弇	合 卄
弉	爿 士 卄
弌	弋 一
弍	弋 二
弎	弋 三
弐	一 弋 二
弒	乂 木 丶 工
弔	弓 丨
弖	弓 一
弙	弓 一 {于下}
弚	丷 弓 丨
弜	弓 弓
弝	弓 巴
弞	弓 欠
弡	弓 匚 コ
弢	弓 屮 又
弣	弓 亻 寸
弤	弓 {卬左} 七 丶
弨	弓 刀 口
弫	弓 臣
弬	弓 臣
弮	丷 夫 弓
弰	弓 小 月
弲	弓 口 月
弳	弓 一 巛 工
弴	弓 {京頭} 子
張	弓 長
弶	弓 {京頭} 小
強	弓 厶 虫
弸	弓 月 月
弻	弓 一 囗 弓
弽	弓 世 木
弾	弓 ⺍ 日 十
弿	宀 {冓上} 八 弓
彁	弓 丁 口 口
彂	业 弓 矢
彃	弓 日 卄 キ
彄	弓 匚 口 口
彅	弓 䒑 月 刀
彆	丷 巾 八 弓
彇	弓 肀 片 一
彈	弓 口 口 十
彉	弓 龷 由 八
彊	弓 一 田 一
彋	弓 罒 一 𧘇
彌	弓 一 八 乂
彍	弓 广 龷 八
彎	言 糹 糹 弓
彏	弓 目 目 又
彑	彑
彔	彑 水
彙	彑 冖 日 木
彚	彐 冖 日 木
彛	彐 米 八 卄
彜	彑 米 八 卄
彞	彐 米 糸 卄
彟	彐 寸 艹 又
彠	彐 工 口 又
彣	文 彡
彥	文 厂 彡
彧	戈 口 一 {两撇}
彨	一 {冂丶} {冂丶} 彡
彫	⺆ 土 口 彡
彮	穴 人 口 彡
彯	西 示 彡
彲	一 {冂丶} 一 彡
彴	彳 勹 丶
彵	彳 也
彶	彳 乃 乀
彸	彳 八 厶
彺	彳 王
彽	彳 {卬左} 七 丶
彾	彳 人 丶 マ
彿	彳 弓 {介下}
徃	彳 生
徆	彳 西
徍	彳 土 土
徎	彳 口 王
徏	彳 止 小
徑	彳 一 巛 工
従	彳 䒑 龰
徔	彳 艹 之
徖	彳 宀 示
徚	彳 木 囗 丷
徛	彳 大 丁 口
徝	彳 十 且
從	彳 人 人 龰
徟	彳 ⺆ 土 口
徠	彳 來
徢	彳 一 彐 龰
徣	彳 龷 日
徤	彳 彐 キ 廴
徥	彳 日 一 龰
徦	彳 尸 二 又
徧	彳 户 冊
復	彳 𠂉 日 夊
徫	彳 韋
徬	彳 亠 丷 方
徯	彳 爪 幺 大
徰	彳 一 止 止
徱	彳 西 示
徲	彳 尸 水 牛
徳	彳 十 罒 心
徴	{微上} 王
徶	彳 丷 巾 夊
徸	彳 立 里
徹	彳 亠 厶 夊
徺	彳 土 土 兀
徻	彳 人 一 日
徾	{微上} 言
徿	彳 立 月 {龍右}
忀	彳 {京頭} 口 𧘇
忁	彳 日 屮 水
忂	彳 目 目 隹
忇	忄 力
忈	二 心
忊	忄 丁
忋	忄 己
忎	千 心
忓	忄 干
忔	忄 𠂉 乙
忕	忄 大
忚	忄 也
忛	忄 几 丶
応	广 心
忞	文 心
忟	忄 文
忢	一 {五下} 心
忣	忄 乃 乀
忥	气 心
忦	忄 人 {介下}
忨	忄 一 兀
忩	八 厶 心
忬	忄 予
忯	忄 {卬左} 七
忰	忄 九 十
忲	忄 大 丶
忳	忄 七 凵
忴	忄 人 丶 乛
忶	忄 二 厶
忷	忄 乂 凵
忹	忄 王
忺	忄 欠
忼	忄 亠 几
怇	忄 匚 コ
怈	忄 世
怉	忄 勹 巳
怋	忄 巳 七
怌	忄 不 一
怐	忄 勹 口
怑	忄 丷 キ
怓	忄 女 又
怗	忄 卜 口
怘	古 心
怚	忄 且
怞	忄 由
怟	忄 {卬左} 七 丶
怢	忄 丿 夫
怣	丿 夫 心
怤	亻 寸 心
怬	忄 囗 儿
怭	忄 心 丿
怮	忄 幺 力
怰	忄 亠 幺
怱	勹 {两撇} 丶 心
怲	忄 一 冂 人
怳	忄 口 儿
怴	忄 戈 乚
怶	忄 皮
怷	木 丶 心
怸	木 丶 心
怹	亻 也 心
怺	忄 丶 水
怽	忄 未
怾	忄 口 八
恀	忄 夕 夕
恄	忄 士 口
恅	忄 耂 匕
恆	忄 一 月 一
恇	忄 匚 王
恈	忄 厶 牛
恉	忄 匕 日
恊	忄 力 力 力
恌	忄 儿 二 二
恎	忄 至
恏	女 子 心
恑	忄 冖 厂 㔾
恓	忄 西
恔	忄 亠 八 乂
恖	{囟框} 乂 心
恗	忄 大 一 丂
恘	忄 亻 木
恛	忄 囗 口
恜	忄 弋 工
恞	忄 大 弓
恟	忄 勹 乂 凵
恠	忄 {左上} 丨 土
恡	忄 乂 {左上} 厶
恥	耳 心
恦	忄 向
恮	忄 人 王
恱	忄 八 厶 儿
恲	忄 䒑 卄
恴	亠 日 心
恵	一 由 心
恷	亻 木 心
恾	忄 艹 亡
悀	忄 マ 用
悁	忄 口 月
悂	忄 匕 匕 土
悅	忄 八 口 儿
悆	人 一 木 心
悇	忄 人 一 木
悈	忄 戈 卄
悊	扌 斤 心
悋	忄 文 口
悎	忄 ⺧ 口
悏	忄 大 人 人
悐	犭 火 心
悑	忄 甫
悓	忄 見
悕	忄 乂 {左上} 巾
悗	忄 冖 口 儿
悘	匚 矢 心
悙	忄 {京頭} 了
悜	忄 口 王
悞	忄 口 ㇉ 大
悡	禾 刂 心
悢	忄 丶 艮
悤	{囟框} 夊 心
悥	言 心
悧	忄 禾 刂
悩	忄 ⺍ 乂 凵
悪	丌 口 一 心
悮	忄 口 一 大
悰	忄 宀 示
悳	十 目 乚 心
悵	忄 長
悶	門 心
悷	忄 户 犬
悹	宀 尸 コ 心
悺	忄 宀 尸 コ
悽	忄 十 彐 女
悾	忄 穴 工
悿	忄 一 大 丶
惀	忄 人 一 冊
惁	木 斤 心
惂	忄 冖 臼
惃	忄 日 匕 匕
惄	上 小 又 心
惇	忄 {京頭} 子
惈	忄 日 木
惉	氵 卜 口 心
惌	宀 夕 㔾 心
惍	忄 金
惎	其 心
惏	忄 木 木
惐	忄 戈 口 一
惒	禾 口 心
惓	忄 丷 夫 㔾
惔	忄 火 火
惖	日 勹 {两撇} 心
惗	忄 人 丶 心
惙	忄 又 又 又
惛	忄 {卬左} 七 日
惞	忄 斤 欠
惡	一 {亞下} 心
惢	心 心 心
惣	牛 勹 {两撇} 心
惤	忄 弓 亠 幺
惥	臼 人 心
惪	十 且 心
惱	忄 巛 {囟框} 乂
惲	忄 冖 車
惵	忄 世 木
惷	𡗗 日 心
惸	忄 勹 日 子
惻	忄 貝 刂
惼	忄 户 冊
惽	忄 巳 七 日
惾	忄 乂 凵 夊
惿	忄 日 一 龰
愂	十 冖 子 心
愃	忄 宀 一 一
愄	忄 田 {畏下}
愅	忄 革
愇	忄 韋
愊	忄 一 口 田
愋	忄 爪 干 又
愌	忄 冖 冂 大
愐	忄 面
愑	忄 マ 用 力
愒	忄 日 勹 乚
愓	忄 日 一 {两撇}
愔	忄 立 日
愖	忄 其 乚
愗	予 丿 夊 心
愘	忄 宀 夊 口
愙	宀 夊 口 心
愛	爪 冖 心 夊
愜	忄 匚 大 人
愝	忄 匚 日 女
愞	忄 而 大
愡	忄 勹 {两撇} 心
愢	忄 田 心
愥	忄 艹 冂 大
愨	{穀頭} 一 心
愩	忄 工 貝
愪	忄 口 貝
愬	䒑 屮 月 心
愭	忄 耂 匕 日
愮	忄 爪 缶
愯	忄 隹 又
愰	忄 日 小 兀
愱	忄 疒 矢
愲	忄 骨
愳	目 目 心
愴	忄 人 丶 口
愵	忄 弓 二 二
愶	忄 力 力 月
愷	忄 山 一 䒑
愸	來 力 心
愹	忄 穴 人 口
愺	忄 艹 早
愻	子 丿 糸 心
愼	忄 匕 目 八
愽	忄 甫 寸
愾	忄 气 米
慀	忄 爪 幺 大
慁	囗 豕 心
慂	氵 マ 用 心
慃	忄 八 厶 习
慄	忄 西 木
慅	忄 又 丶 虫
慆	忄 爪 臼
慇	⺁ 彐 乛 心
慉	忄 亠 幺 田
態	厶 月 匕 心
慍	忄 囗 人 皿
慏	忄 冖 日 八
慐	工 貝 心
慒	忄 艹 日 日
慓	忄 西 示
慔	忄 艹 日 大
慖	忄 囗 戈 一
慗	木 口 夊 心
慘	忄 厶 厶 彡
慙	車 斤 心
慚	忄 車 斤
慛	忄 山 隹
慜	𠂉 母 夊 心
慞	忄 立 早
慟	忄 千 里 力
慠	忄 龶 勹 夊
慡	忄 大 乂 乂
慣	忄 {母框} 十 貝
慤	{穀頭} 几 心
慥	忄 ⺧ 口 辶
慦	一 水 丶 心
慩	忄 車 辶
慪	忄 匚 口 口
慫	彳 人 人 心
慬	忄 革 二
慭	一 米 犬 心
慮	{虎头} 田 心
慯	忄 𠂉 日 {两撇}
慱	忄 {專上} 寸
慲	忄 卄 一 入
慳	忄 臣 又 土
慴	忄 习 习 白
慶	{鹿上} 乛 心 夊
慸	卌 一 冖 心
慹	土 䒑 十 心
慺	忄 口 十 女
慻	忄 丷 夫 目
慼	戊 上 小 心
慽	忄 戊 上 小
慾	八 人 口 心
慿	二 {馬上} 卄 心
憀	忄 习 习 彡
憁	忄 {囟框} 夊 心
憂	丆 月 冖 夊
憃	𡗗 臼 心
憄	彳 十 且 心
憅	千 里 力 心
憆	忄 尚 土
憇	舌 卄 二 心
憈	忄 {虎头} 业
憉	忄 士 口 彡
憊	亻 龷 丿 心
憌	金 勹 二 心
憍	忄 夭 口 口
憏	忄 {祭上} 示
憐	忄 米 夕 ヰ
憑	二 馬 心
憒	忄 口 丄 貝
憓	忄 {專上} 心
憕	忄 癶 一 䒑
憖	來 犬 心
憗	來 夊 心
憘	忄 士 口 口
憙	士 口 䒑 心
憚	忄 口 口 十
憛	忄 西 早
憜	忄 阝 {左上} 月
憞	忄 {京頭} 子 夊
憟	忄 西 米
憠	厂 䒑 屮 心
憡	忄 竹 木 冂
憢	忄 土 土 兀
憣	忄 丿 米 田
憤	忄 十 卄 貝
憥	火 火 冖 心
憦	忄 火 火 力
憪	忄 門 月
憫	忄 門 文
憭	忄 大 丷 小
憮	忄 𠂉 卌 灬
憯	忄 匚 儿 日
憰	忄 予 丿 口
憱	忄 {京頭} 小 尤
憲	宀 丰 罒 心
憳	忄 彐 工 寸
憴	忄 黽
憵	尸 口 辛 心
憶	忄 立 日 心
憸	忄 僉
憹	忄 冂 龷 辰
憺	忄 冖 厂 言
憻	忄 亠 囗 一
憼	艹 勹 口 心
憽	忄 艹 勹 心
憿	忄 白 方 夊
懀	忄 人 一 日
懁	忄 罒 一 𧘇
懃	革 二 力 心
懄	忄 革 二 力
懅	忄 {虎头} 豕
懆	忄 口 口 木
懇	豸 艮 心
應	广 亻 隹 心
懌	忄 罒 土 十
懍	忄 亠 囗 禾
懎	忄 土 人 口
懏	忄 隹 {雋下}
懐	忄 亠 罒 𧘇
懓	忄 爪 冖 夊
懕	厂 日 月 心
懖	金 舌 心
懗	忄 土 {介下} 八
懘	氵 卌 一 心
懙	忄 臼 丂 八
懚	忄 爪 工 心
懛	忄 士 口 至
懜	忄 艹 罒 夕
懝	忄 匕 矢 龰
懞	忄 艹 冖 豕
懟	业 羊 寸 心
懠	忄 亠 丷 二
懡	忄 麻 丿 厶
懢	忄 臣 {⺮右} 皿
懣	氵 卄 一 心
懤	忄 士 乛 寸
懥	忄 十 冖 龰
懧	忄 宀 心 丁
懨	忄 厂 日 犬
懩	忄 䒑 夫 艮
懪	忄 日 龷 水
懫	忄 斤 斤 貝
懬	广 龷 由 心
懭	忄 广 龷 八
懮	忄 丆 月 夊
懯	甫 方 夊 心
懰	忄 卯 金 刂
懱	忄 艹 罒 丶
懲	{微上} 一 王 心
懳	忄 丰 丰 心
懴	忄 十 戈 一
懶	忄 木 口 貝
懷	忄 亠 罒 𧘇
懸	且 小 丿 心
懹	忄 {京頭} 口 𧘇
懺	忄 人 人 一
懻	忄 丬 匕 八
懼	忄 目 目 隹
懽	忄 艹 口 隹
懾	忄 耳 耳 耳
戀	言 糹 糹 心
戁	卄 一 口 心
戂	忄 麻 非
戃	忄 尚 黑
戄	忄 目 目 又
戅	立 早 工 心
戇	立 早 夊 心
戉	戈 乚
戓	戈 口
戔	戈 戈
戙	冂 一 口 戈
戜	戈 口 王
戝	貝 戈
戞	丆 月 冖 戈
戠	立 日 戈
戣	癶 一 大 戈
戦	⺍ 日 十 戈
戧	人 丶 彐 戈
戨	丁 口 丁 戈
戩	一 厶 厶 戈
戫	{左上} 月 戈 一
戭	宀 一 由 戈
戯	{虎头} 业 戈
戰	口 口 日 戈
戱	{虎头} 丱 一 戈
戲	{虎头} 一 口 戈
戵	目 目 隹 戈
戶	戶
戸	戸
戹	户 乙
戺	户 巳
戻	户 大
戼	乛 匚 一 コ
扂	户 卜 口
扄	户 向
扅	户 夕 夕
扆	户 亠 𧘇
扊	户 火 火
扏	扌 九
扐	扌 力
払	扌 厶
扖	扌 入
扗	扌 土
扙	扌 {左上} 乀
扚	扌 勹 丶
扜	扌 一 {于下}
扝	扌 一 丂
扞	扌 干
扟	扌 乛 十
扠	扌 又 丶
扡	扌 也
扢	扌 𠂉 乙
扤	扌 兀
扥	扌 丿 七
扨	扌 刀 丶
扱	扌 乃 乀
扲	扌 人 丶 乛
扴	扌 人 {介下}
扵	扌 人 ⺀
扷	扌 夭
扸	扌 片
扺	扌 {卬左} 七
扻	扌 欠
扽	扌 七 凵
抁	扌 厶 儿
抂	扌 王
抃	扌 亠 卜
抅	扌 勹 厶
抆	扌 文
抇	扌 日
抈	扌 月
抋	扌 心
抌	扌 冖 儿
抍	扌 丿 卄
抎	扌 二 厶
抏	扌 一 兀
抐	扌 冂 人
抔	扌 不
抙	扌 手
抜	扌 {左上} 又
抝	扌 幺 乛
択	扌 尸 乀
抣	扌 勹 二
抦	扌 一 冂 人
抧	扌 口 八
抩	扌 冂 土
抪	扌 {左上} 巾
抭	扌 宀 几
抮	扌 人 彡
抯	扌 且
抰	扌 冂 大
抲	扌 丁 口
抳	扌 尸 匕
抴	扌 世
抶	扌 丿 夫
抷	扌 不 一
抸	扌 丿 之
抺	扌 未
抾	扌 土 厶
拀	扌 口 儿
拁	扌 力 口
拃	扌 𠂉 {乍下}
拋	扌 尢 力
拏	女 又 手
拑	扌 卄 二
拕	扌 宀 匕
拝	扌 一 丰
拞	扌 斤 一
拠	扌 夊 几
拡	扌 广 厶
拤	扌 上 卜
拪	扌 西
拫	扌 艮
拰	扌 亻 壬
拲	龷 八 手
拵	扌 {左上} 丨 子
拸	扌 夕 夕
拹	扌 力 力 力
拺	扌 木 冂
拻	扌 {左上} 火
挀	扌 ⺁ 𧘇
挃	扌 至
挄	扌 小 兀
挅	扌 乃 木
挆	扌 几 木
挊	扌 上 下
挋	扌 臣
挌	扌 夊 口
挍	扌 亠 八 乂
挏	扌 冂 一 口
挐	女 口 手
挒	扌 一 夕 刂
挓	扌 宀 丿 七
挔	扌 亠 𧘇
挕	扌 耳
挗	扌 大 弓
挘	扌 小 丿 力
挙	{兴上} 八 手
挜	扌 丌 䒑
挦	扌 彐 寸
挧	扌 习 习
挩	扌 八 口 儿
挬	扌 十 冖 子
挭	扌 一 日 乂
挮	扌 丷 弓 丿
挰	扌 口 王
挱	扌 氵 小 丿
挳	扌 一 巛 工
挴	扌 𠂉 母
挵	扌 王 卄
挶	扌 尸 乛 口
挷	扌 丰 阝
挸	扌 見
挻	扌 丿 止 廴
挼	扌 爪 女
挾	扌 大 人 人
挿	扌 千 日
捀	扌 夊 丰
捁	扌 ⺧ 口
捄	扌 一 水 丶
捇	扌 土 {介下} 八
捈	扌 人 一 木
捊	扌 爪 子
捑	扌 日 乚 大
捒	扌 木 口
捓	扌 牙 阝
捔	扌 冖 用
捖	扌 宀 一 兀
捗	扌 止 小
捘	扌 厶 八 夊
捙	扌 車
捚	扌 里
捛	扌 口 口
捜	扌 申 又
捝	扌 丷 口 儿
捠	扌 斤 一 八
捤	扌 尸 毛
捥	扌 宀 夕 㔾
捦	扌 金
捨	扌 人 干 口
捪	扌 {卬左} 七 日
捫	扌 門
捬	扌 广 亻 寸
捯	扌 至 刂
捰	扌 日 木
捲	扌 丷 夫 㔾
捳	扌 斤 一 山
捴	扌 八 厶 心
捵	扌 冂 龷 八
捸	扌 彐 水
捹	扌 大 十 卄
捼	扌 禾 女
捽	扌 亠 人 十
捾	扌 宀 尸 コ
捿	扌 十 彐 女
掁	扌 長
掃	扌 彐 冖 巾
掄	扌 人 一 冊
掅	扌 龶 月
掆	扌 冂 䒑 山
掋	扌 广 {卬左} 丶
掍	扌 日 匕 匕
掑	扌 其
掓	扌 上 小 又
掔	臣 又 手
掕	扌 土 八 夊
掗	扌 一 {亞下}
掙	扌 爪 彐 亅
掚	扌 一 巾 入
掛	扌 土 土 卜
掜	扌 臼 儿
掝	扌 戈 口 一
掞	扌 火 火
掟	扌 宀 一 龰
採	扌 爪 木
掤	扌 月 月
掦	扌 日 勹 {两撇}
掫	扌 耳 又
掯	扌 止 月
掱	手 手 手
掲	扌 日 勹 匕
掵	扌 合 卩
掶	扌 广 彐 人
掹	扌 子 皿
掻	扌 又 虫
掽	扌 䒑 业
掿	扌 艹 {左上} 口
揀	扌 木 囗 丷
揁	扌 卜 貝
揂	扌 丷 酉
揃	扌 䒑 月 刂
揅	石 一 卄 手
揇	扌 十 冂 十
揈	扌 勹 言
揊	扌 一 口 田
揋	扌 田 {畏下}
揌	扌 田 心
揑	扌 臼 工
揓	扌 方 𠂉 也
揔	扌 勹 {两撇} 心
揕	扌 其 乚
揗	扌 ⺁ 十 目
揘	扌 白 王
揙	扌 户 冊
揚	扌 日 一 {两撇}
換	扌 冖 冂 大
揜	扌 合 卄
揝	扌 夊 卜 日
揟	扌 乛 龰 月
揢	扌 宀 夊 口
揤	扌 彐 厶 卩
揥	扌 亠 丷 巾
揦	扌 木 口 刂
揧	木 口 刂 手
揨	扌 {亮頭} 丁
揫	禾 火 手
揬	扌 穴 犬
揮	扌 冖 車
揯	扌 忄 一 一
揰	扌 千 里
揱	小 月 刂 手
揳	扌 丰 刀 大
揵	扌 彐 キ 廴
揷	扌 千 臼
揹	扌 丬 匕 月
揺	扌 爪 干 凵
揻	扌 戊 一 女
揼	扌 石 水
揾	扌 日 皿
搃	扌 丷 口 心
搄	扌 忄 一 一
搆	扌 {冓上} 冂 土
搇	扌 人 丶 𧘇
搈	扌 穴 人 口
搉	扌 冖 隹
搊	扌 勹 屮 屮
損	扌 口 貝
搎	扌 子 丿 糸
搑	扌 艹 耳
搒	扌 亠 丷 方
搕	扌 土 厶 皿
搖	扌 月 缶
搗	扌 {鳥上} 山
搘	扌 耂 匕 日
搙	扌 辰 寸
搚	扌 力 力 月
搝	扌 自 犬
搟	扌 車 干
搢	扌 丌 䒑 日
搣	扌 戊 一 火
搤	扌 䒑 八 皿
搥	扌 𠂤 辶
搧	扌 户 习 习
搨	扌 日 习 习
搩	扌 夕 ヰ 木
搫	舟 殳 手
搮	扌 西 木
搯	扌 爪 臼
搰	扌 骨
搱	扌 尸 辛
搲	扌 穴 瓜
搳	扌 宀 丰 口
搵	扌 囗 人 皿
搶	扌 人 丶 口
搷	扌 十 且 八
搸	扌 𡗗 禾
搹	扌 一 口 丨
搻	合 手 手
搼	扌 丷 夫 手
搾	扌 穴 𠂉 {乍下}
摀	扌 烏
摂	扌 耳 二 二
摃	扌 工 貝
摉	扌 穴 人 夕
摋	扌 乂 木 殳
摌	扌 立 丿 生
摍	扌 宀 亻 日
摎	扌 习 习 彡
摏	扌 𡗗 臼
摐	扌 彳 人 龰
摑	扌 囗 戈 一
摓	扌 夊 丰 辶
摕	扌 卌 一 巾
摖	扌 {祭上} 示
摗	扌 木 口 欠
摙	扌 車 辶
摚	扌 尚 土
摛	扌 文 凵 厶
摜	扌 {母框} 十 貝
摝	扌 鹿
摟	扌 口 十 女
摠	扌 {囟框} 夊 心
摡	扌 彐 厶 儿
摢	扌 {虎头} 丿 {于下}
摣	扌 {虎头} 且
摤	扌 大 乂 乂
摥	扌 𠂉 日 {两撇}
摦	扌 大 一 瓜
摨	扌 尸 水 牛
摪	扌 爿 月 寸
摫	扌 夫 見
摬	扌 立 日 儿
摮	龶 勹 夊 手
摯	土 䒑 十 手
摰	土 八 土 手
摱	扌 日 罒 又
摲	扌 車 斤
摳	扌 匚 口 口
摴	扌 雨 一 丂
摵	扌 戊 上 小
摶	扌 {專上} 寸
摷	扌 巛 日 木
摻	扌 厶 厶 彡
摼	扌 臣 又 土
摽	扌 西 示
摾	扌 弓 口 虫
摿	扌 人 立 日
撀	士 {眉上} 殳 手
撁	扌 亠 幺 牛
撃	車 殳 手
撆	丷 巾 八 手
撈	扌 火 火 力
撉	{京頭} 子 夊 手
撊	扌 門 月
撋	扌 門 王
撌	扌 口 丄 貝
撍	扌 匚 儿 日
撎	扌 士 冖 䒑
撏	扌 彐 工 寸
撐	扌 尚 牙
撓	扌 土 土 兀
撔	扌 日 {京頭} 小
撗	扌 龷 由 八
撘	扌 竹 合
撚	扌 月 犬 灬
撛	扌 米 夕 ヰ
撜	扌 癶 一 䒑
撝	扌 爪 {爲下}
撟	扌 夭 口 口
撠	扌 十 早 戈
撡	扌 厶 厶 丶
撢	扌 西 早
撣	扌 口 口 十
撥	扌 癶 弓 殳
撦	扌 大 耂 日
撧	扌 糹 冖 巴
撨	扌 隹 灬
撪	扌 厶 大 車
撫	扌 𠂉 卌 灬
撯	扌 羊 目
撱	扌 阝 {左上} 月
撲	扌 业 䒑 夫
撳	扌 金 欠
撴	扌 {京頭} 子 夊
撶	扌 艹 干 龷
撹	扌 ⺍ 冖 見
撻	扌 土 羊 辶
撽	扌 白 方 夊
撾	扌 咼 辶
撿	扌 僉
擁	扌 亠 {纟上} 隹
擃	扌 冂 龷 辰
擄	扌 {虎头} 田 力
擆	扌 艹 耂 日
擇	扌 罒 土 十
擈	扌 业 羊 八
擉	扌 罒 勹 虫
擊	車 凵 殳 手
擋	扌 尚 田
擌	扌 竹 大 人
擏	扌 艹 勹 夊
擑	扌 口 耳 戈
擓	扌 匚 氵 隹
擔	扌 冖 厂 言
擕	扌 隹 {雋下}
擖	扌 艹 日 乚
擙	扌 {向框} 米 大
據	扌 {虎头} 豕
擛	扌 艹 世 木
擜	扌 十 冂 犬
擝	扌 日 月 皿
擟	扌 一 八 乂
擠	扌 亠 丷 二
擡	扌 士 口 至
擣	扌 士 乛 寸
擥	臣 {⺮右} 罒 手
擧	臼 丂 丄 手
擨	扌 ⺁ 虎 欠
擩	扌 雨 而
擪	厂 日 月 手
擫	扌 厂 日 犬
擬	扌 匕 矢 龰
擭	扌 艹 隹 又
擮	扌 十 戈 隹
擯	扌 宀 一 貝
擰	扌 宀 心 丁
擱	扌 門 夊 口
擲	扌 丷 酉 阝
擳	扌 竹 彐 卩
擴	扌 广 龷 八
擵	扌 麻 手
擶	扌 竹 䒑 刂
擷	扌 士 口 貝
擸	扌 巛 囗 {鼠下}
擹	扌 卄 一 欠
擺	扌 罒 厶 匕
擻	扌 口 十 夊
擼	扌 魚 日
擽	扌 白 幺 木
擾	扌 丆 月 夊
擿	扌 亠 丷 辶
攁	扌 䒑 夫 艮
攂	扌 田 田 田
攃	扌 艹 {祭上} 示
攄	扌 {虎头} 田 心
攅	扌 夫 夫 貝
攆	扌 夫 夫 車
攇	扌 宀 丰 心
攈	扌 鹿 禾
攊	扌 厂 禾 止
攋	扌 木 口 貝
攌	扌 囗 罒 𧘇
攍	扌 {贏頭} 女
攎	扌 {虎头} 田 皿
攏	扌 立 月 {龍右}
攐	扌 宀 {冓上} 𧘇
攑	扌 臼 丂 キ
攓	扌 宀 {冓上} 足
攔	扌 門 木 丷
攕	扌 人 人 一
攖	扌 貝 貝 女
攗	扌 鹿 米
攙	扌 冖 口 丶
攚	扌 火 火 口
攛	扌 穴 臼 {鼠下}
攜	扌 山 隹 口
攝	扌 耳 耳 耳
攞	扌 罒 糹 隹
攟	扌 鹿 囗 禾
攠	扌 麻 非
攡	扌 文 凵 隹
攢	扌 ⺧ 儿 貝
攣	言 糹 糹 手
攤	扌 卄 一 隹
攦	扌 一 {冂丶} 鹿
攧	扌 十 且 貝
攨	扌 穴 瓜 瓜
攩	扌 尚 黑
攪	扌 臼 乂 見
攬	扌 臣 {⺮右} 見
攭	扌 {互中} 豕 虫
攰	十 又 力
攱	立 十 又
攲	大 丁 口 又
攳	十 又 彐 寸
攷	丂 夊
攺	巳 夊
攼	干 夊
攽	八 刀 夊
敀	白 夊
敁	卜 口 卜 又
敂	勹 口 夊
敃	巳 七 夊
敄	予 丿 夊
敆	合 卜 又
敇	木 冂 夊
敊	上 小 卜 又
敋	夊 口 夊
敍	人 一 木 又
敎	乂 {左上} 子 夊
敐	辰 夊
敒	亻 申 夊
敓	八 口 儿 夊
敔	一 {五下} 口 夊
敗	貝 夊
敘	人 一 木 夊
敚	丷 口 儿 夊
敜	人 丶 乛 夊
敟	冂 龷 八 夊
敠	又 又 又 又
敡	日 勹 {两撇} 又
敤	日 木 卜 又
敥	火 火 卜 又
敧	大 丁 口 又
敨	立 口 夊
敩	⺍ 冖 子 夊
敪	又 又 又 夊
敭	日 一 勹 夊
敮	千 臼 卜 又
敯	巳 七 日 又
敱	山 一 口 又
敳	山 一 口 夊
敵	亠 丷 冂 夊
敶	阝 木 日 夊
數	口 十 口 夊
敹	卜 冖 丿 夊
敺	匚 口 口 又
敻	冖 冂 人 夊
敼	士 口 䒑 又
敽	夭 口 冂 又
敾	羊 䒑 口 夊
敿	夭 口 冂 夊
斀	罒 勹 虫 又
斁	罒 土 䒑 夊
斂	僉 夊
斃	丷 巾 八 匕
斄	未 夊 厂 來
斅	臼 乂 乂 又
斆	臼 乂 乂 夊
斈	文 子
斉	文 {介下} 二
斊	文 耳
斍	文 見
斎	文 {介下} 示
斏	文 丶 艮
斒	文 户 冊
斔	文 虫 臼 人
斕	文 門 木 丷
斖	文 臼 冂 且
斘	夕 ⺀ 十
斚	厶 厶 冖 十
斝	口 口 冖 十
斞	臼 人 ⺀ 十
斠	{冓上} 冂 土 十
斢	龷 由 八 十
斣	罒 勹 虫 十
斦	斤 斤
斨	爿 斤
斪	勹 口 斤
斬	車 斤
斮	龷 日 斤
斱	耂 日 斤
斲	匚 コ {亞下} 斤
斳	革 二 斤
斴	米 夕 ヰ 斤
斵	卯 一 {亞下} 斤
斶	斤 罒 勹 虫
斷	幺 幺 一 斤
斸	尸 水 罒 斤
斺	方 人 {介下}
斻	方 𠂉 几
斾	方 𠂉 巾
斿	方 𠂉 子
旀	方 厶 小
旂	方 𠂉 斤
旇	方 𠂉 皮
旈	方 亠 厶 {荒下}
旉	甫 方
旊	方 𠂉 瓦
旍	方 𠂉 人 マ
旐	方 𠂉 儿 二
旑	方 大 丁 口
旓	方 𠂉 小 月
旔	方 彐 キ 廴
旕	方 人 ⺀ 匕
旘	方 立 日 戈
旙	方 丿 米 田
旚	方 𠂉 西 示
旛	方 𠂉 丿 田
旜	方 𠂉 亠 一
旝	方 𠂉 人 日
旞	方 𠂉 䒑 辶
旟	方 𠂉 臼 八
旡	匚 儿
旣	白 匕 匚 儿
旤	咼 匚 儿
旪	日 十
旫	日 刀
旲	日 大
旳	日 勹 丶
旴	日 一 {于下}
旵	日 山
旸	日 𠄎 {两撇}
旹	屮 一 日
旻	日 文
旼	日 文
旽	日 七 凵
旾	七 凵 日
旿	日 𠂉 十
昁	日 一 巾
昄	日 ⺁ 又
昅	日 乃 乀
昇	日 丿 卄
昈	日 户
昉	日 方
昋	一 大 日
昍	日 日
昐	日 八 刀
昑	日 人 丶 乛
昒	日 勹 {两撇}
昖	日 八 厶
昗	日 亠 八
昘	日 方
昚	大 丷 日
昛	日 匚 コ
昜	日 一 勹 {两撇}
昞	日 一 冂 人
昡	日 亠 幺
昢	日 屮 凵
昣	日 人 彡
昤	日 人 丶 マ
昦	日 大 {介下}
昩	日 末
昪	日 厶 卄
昫	日 勹 口
昬	巳 七 日
昮	日 工 力
昰	日 一 止
昲	日 弓 {介下}
昳	日 丿 夫
昷	日 皿
昸	日 夊 ⺀
昹	日 丶 水
昺	日 一 冂 人
昻	日 工 卩
昽	日 尤 丿
昿	日 广 厶
晀	日 儿 二 二
時	日 土 寸
晄	日 小 兀
晅	日 一 日 一
晆	日 土 土
晇	日 大 一 丂
晈	日 亠 八 乂
晉	一 厶 厶 日
晊	日 至
晍	日 冂 一 口
晎	日 龷 八
晐	日 亥
晑	日 向
晘	日 日 干
晙	日 厶 八 夊
晛	日 見
晜	日 丷 弓 丿
晝	彐 土 日 一
晞	日 乂 {左上} 巾
晠	日 戊 乛
晢	扌 斤 日
晣	日 扌 斤
晥	日 宀 一 兀
晧	日 ⺧ 口
晩	日 冖 日 儿
晪	日 冂 龷 八
晫	日 卜 早
晬	日 亠 人 十
晭	日 ⺆ 土 口
晱	日 火 火
晲	日 臼 儿
晳	木 斤 日
晵	户 夊 日
晸	日 一 止 夊
晹	日 日 勹 {两撇}
晻	日 大 电
晼	日 宀 夕 㔾
晽	日 木 木
晿	日 日 日
暀	日 彳 丶 王
暁	日 十 卄 兀
暃	日 非
暅	日 忄 一 一
暆	日 方 𠂉 也
暈	日 冖 車
暉	日 冖 車
暊	日 丆 貝
暋	巳 七 夊 日
暍	日 日 勹 乚
暎	日 艹 冂 大
暏	日 耂 日
暐	日 韋
暒	日 日 生
暓	予 丿 夊 日
暔	日 十 冂 十
暕	日 木 囗 丷
暘	日 日 一 {两撇}
暙	日 𡗗 日
暚	日 爪 缶
暛	日 羊 工
暜	立 立 日
暞	日 自 木
暟	日 山 一 䒑
暠	日 高
暡	日 八 厶 习
暢	申 日 一 {两撇}
暣	日 气 米
暤	日 白 大 十
暥	日 日 宀 女
暦	厂 木 木 日
暩	日 {祭上} 示
暪	日 卄 一 入
暫	車 斤 日
暬	土 八 土 日
暭	日 白 二 十
暯	日 艹 日 大
暰	日 彳 人 龰
暱	日 匚 艹 口
暲	日 立 早
暳	日 丰 丰 彐
暵	日 卄 一 夫
暶	日 方 𠂉 龰
暷	日 {專上} 寸
暸	日 大 丷 小
暺	日 口 口 十
暻	日 日 {京頭} 小
暼	丷 巾 八 日
暽	日 米 夕 ヰ
暿	日 士 口 口
曀	日 士 冖 䒑
曁	白 匕 匚 一
曂	日 龷 由 八
曃	日 彐 水 辶
曄	日 艹 干 龷
曅	日 艹 干 龷
曆	厂 禾 禾 日
曇	日 雨 二 厶
曈	日 立 里
曉	日 土 土 兀
曊	日 弓 {介下} 貝
曋	日 西 早
曌	日 月 穴 工
曍	日 自 二 十
曎	日 罒 土 十
曏	日 {纟上} 丿 阝
曐	日 日 日 生
曑	日 日 日 彡
曒	日 白 方 夊
曓	日 屮 凵 一
曔	日 艹 勹 夊
曕	日 冖 厂 言
曖	日 爪 冖 夊
曗	日 业 羊 八
曘	日 雨 而
曚	日 艹 冖 豕
曞	日 厂 艹 禺
曟	日 日 日 辰
曠	日 广 龷 八
曡	日 日 日 且
曢	日 宀 大 小
曣	日 卄 一 灬
曤	日 雨 隹
曥	日 {虎头} 田 皿
曧	日 一 口 虫
曨	日 立 月 {龍右}
曪	日 罒 糹 隹
曫	言 糹 糹 日
曬	日 一 {冂丶} 鹿
曭	日 尚 黑
曮	日 口 口 夊
曯	日 尸 水 虫
曱	冂 干
曵	电 丿 丶
曶	勹 {两撇} 日
書	彐 土 日
曺	一 由 日
曻	日 夕 ヰ
曽	丷 田 日
朁	匚 儿 匚 日
朂	日 耳 力
會	人 一 日 日
朄	申 木 囗 丷
朅	土 厶 日 乚
朆	丷 日 丷 {两撇}
朇	人 一 日 十
朌	月 八 刀
朎	月 人 丶 マ
朏	月 屮 凵
朑	月 世
朒	月 冂 人 人
朓	月 儿 二 二
朖	月 丶 艮
朘	月 厶 八 夊
朙	囗 八 冂 月
朚	亡 日 月
朜	月 {京頭} 子
朞	其 月
朠	月 艹 冂 大
朡	月 乂 凵 夊
朢	臣 月 王
朣	月 立 里
朤	月 月 月 月
朥	月 火 火 力
朧	月 立 月 {龍右}
朩	木
朮	木 丶
朰	木 乙
朲	木 人
朳	木 八
朶	乃 木
朷	木 刀
朸	木 力
朹	木 九
朻	木 丩
朼	木 匕
朾	木 丁
朿	木 冂
杁	木 入
杄	木 千
杅	木 一 {于下}
杇	木 一 丂
杊	木 川
杋	木 几 丶
杍	木 子
杒	木 刀 丶
杔	木 丿 七
杕	木 大
杗	亡 木
杘	尸 木
杙	木 弋
杚	木 𠂉 乙
杛	木 弓
杝	木 也
杢	木 工
杣	木 山
杤	木 一 勹
杦	木 冖 丶
杧	木 亡
杫	木 止
杬	木 一 兀
杮	木 一 巾
東	木 日
杴	木 欠
杶	木 七 凵
杸	木 殳
杹	木 亻 匕
杺	木 心
杻	木 丑
杽	木 手
枀	八 厶 木
枂	木 月
枃	木 勹 二
枅	木 一 卄
枆	木 毛
枈	匕 匕 木
枊	木 {卬左} 卩
枌	木 八 刀
枍	木 八 丂
枎	木 夫
枏	木 冂 二
枑	木 一 彑
枒	木 牙
枓	木 ⺀ 十
枔	木 人 丶 乛
枖	木 夭
枙	木 厂 㔾
枛	木 爪
枟	木 二 厶
枠	木 九 十
枡	木 丿 卄
枤	木 犬
枦	木 户
枩	木 八 厶
枬	木 ⺆ 亠
枮	木 卜 口
枱	木 厶 口
枲	厶 口 木
枴	木 口 刀
枹	木 勹 巳
枺	木 末
枻	木 世
枼	世 木
枽	十 卄 一 木
枾	木 キ {介下}
枿	木 十 卄
柀	木 皮
柂	木 𠂉 也
柅	木 尸 匕
柆	木 立
柇	木 禾
柈	木 丷 キ
柉	木 丿 之
柊	木 夊 ⺀
柋	亻 弋 木
柌	木 乛 一 口
柍	木 冂 大
柎	木 亻 寸
柕	木 予 丿
柖	木 刀 口
柗	木 八 口
柛	木 申
柟	木 冂 土
柡	木 二 水
柣	木 丿 夫
柤	木 且
柦	木 日 一
柧	木 瓜
柨	木 {左上} 巾
柪	木 幺 力
柫	木 弓 {介下}
柭	木 {左上} 又 丶
柮	木 屮 凵
柲	木 心 丿
柵	木 冊
柶	木 囗 儿
柷	木 口 儿
柸	木 不 一
柹	木 丿 ㇉ 丿
柺	木 口 力
査	木 且
柼	木 穴
柾	木 一 止
栁	木 夕 卩
栂	木 母
栃	木 ⺁ 一 勹
栄	⺍ 冖 木
栆	十 口 人 ⺀
栍	木 生
栐	木 丶 水
栒	木 勹 日
栔	丰 刀 木
栕	木 臣
栘	木 夕 夕
栙	木 夊 ヰ
栚	木 䒑 大
栛	木 力 力 力
栜	木 木 冂
栞	干 干 木
栟	木 䒑 卄
栠	亻 壬 木
栢	木 丆 日
栣	木 亻 壬
栤	木 二 水
栥	二 欠 木
栦	木 ⺍ 川
栧	木 电 丿
栨	木 二 欠
栫	木 {左上} 丨 子
栬	木 冖 巴
栭	木 而
栮	木 耳
栯	木 {左上} 月
栰	木 亻 戈
栱	木 龷 八
栴	木 𠂉 ⺆ 亠
栵	木 一 夕 刂
栶	木 囗 大
栺	木 匕 日
栻	木 弋 工
栿	木 亻 犬
桇	女 口 木
桋	木 大 弓
桍	木 大 一 丂
桏	木 工 阝
桒	十 卄 木
桖	木 丿 皿
桗	木 乃 木
桘	木 𠂤
桙	木 厶 牛
桚	木 巛 夕
桛	木 上 下
桜	木 ⺍ 女
桝	木 夕 ヰ
桞	木 夕 阝
桟	木 二 戈
桪	木 彐 寸
桬	氵 小 丿 木
桭	木 辰
桮	木 不 口
桯	木 口 王
桰	木 {卬左} 七 口
桱	木 一 巛 工
桲	木 十 冖 子
桳	木 厶 大 十
桵	木 爪 女
桸	木 乂 {左上} 巾
桹	木 丶 艮
桺	木 丌 匚 コ
桻	木 夊 丰
桼	木 人 水
桽	木 人 人 土
桾	木 彐 丿 口
桿	木 日 干
梀	木 木 口
梂	木 一 水 丶
梄	木 酉
梇	木 王 卄
梈	木 {京頭} 了
梉	木 爿 士
梊	扌 斤 木
梋	木 口 月
梌	木 人 一 木
梍	木 白 七
梎	木 白 匕
梐	木 匕 匕 土
梑	木 犭 火
梒	木 人 丶 口
梔	木 ⺁ 一 巴
梕	木 刀 丶 心
梖	木 貝
梘	木 見
梙	木 口 口 丨
梚	木 冖 口 儿
梛	木 乛 キ 阝
梜	木 大 人 人
條	亻 丨 夊 木
梞	木 己 心
梟	{鳥上} 木
梠	木 口 口
梡	木 宀 一 兀
梣	木 山 人 乛
梤	木 山 八 刀
梥	穴 厶 木
梩	木 里
梪	木 一 口 䒑
梫	木 彐 冖 又
梬	木 由 丂
梮	木 尸 乛 口
梱	木 囗 木
梲	木 八 口 儿
梴	木 丿 止 廴
梶	木 尸 毛
梷	卜 口 又 木
梸	木 禾 刂
梹	木 斤 一 八
梺	木 木 下
梻	木 亻 弓 {介下}
梼	木 丰 寸
梽	木 士 心
梾	木 一 米
梿	木 车 辶
棁	木 丷 口 儿
棃	禾 勹 丿 木
棄	亠 厶 艹 未
棅	木 禾 彐
棆	木 人 一 冊
棇	木 八 厶 心
棈	木 龶 月
棊	其 木
棌	木 爪 木
棎	木 冖 八 木
棏	木 日 一 寸
棐	非 木
棑	木 非
棓	木 立 口
棔	木 {卬左} 七 日
棖	木 長
棗	木 冂 木 冂
棙	木 户 犬
棛	木 亠 厶 月
棜	木 方 人 ⺀
棝	木 囗 古
棞	木 囗 禾
棟	木 木 日
棡	木 冂 䒑 山
棢	木 冂 䒑 亡
棤	木 龷 日
棥	木 乂 乂 木
棦	木 冖 彐 亅
棧	木 戈 戈
棨	户 夊 木
棩	木 片 爿 一
棪	木 火 火
棫	木 戈 口 一
棬	木 丷 夫 㔾
棭	木 亠 亻 乀
棯	木 人 丶 心
棲	木 十 彐 女
棳	木 又 又 又
棴	木 月 卩 又
棶	木 來
棷	木 耳 又
棸	耳 又 木
棻	艹 八 刀 木
棽	木 木 人 乛
棾	木 木 冖 几
棿	木 臼 儿
椀	木 宀 夕 㔾
椂	木 彐 水
椃	木 虎
椄	木 立 女
椆	木 ⺆ 土 口
椇	木 且 八
椈	木 勹 米
椉	亠 夕 ヰ 木
椊	木 亠 人 十
椌	木 穴 工
椏	木 一 {亞下}
椑	木 {卑上} 十
椓	木 豕 丶
椔	木 巛 田
椕	木 八 刀 木
椖	木 户 方
椗	木 宀 一 龰
椘	木 木 之
椙	木 日 日
椚	木 門
椛	木 艹 亻 匕
検	木 合 人
椝	夫 见 木
椞	木 斤 木
椡	木 至 刂
椢	木 囗 王 丶
椣	木 冂 龷 八
椥	木 矢 口
椦	木 丷 夫 力
椧	木 合 卩
椨	木 广 亻 寸
椩	木 广 彐 人
椪	木 䒑 业
椫	木 丷 日 十
椬	木 宀 且
椮	木 厶 大 彡
椯	木 山 而
椱	木 𠂉 日 夊
椲	木 韋
椳	木 田 {畏下}
椵	木 尸 二 又
椶	木 乂 凵 夊
椷	木 戊 一 口
椸	木 方 𠂉 也
椺	木 亻 口 木
椻	木 匚 日 女
椼	木 彳 氵 亍
椾	木 䒑 月 刂
楀	木 丿 虫 冂
楁	木 宀 夊 口
楃	木 尸 至
楄	木 户 冊
楅	木 一 口 田
楆	木 西 女
楇	木 咼
楈	木 乛 龰 月
楉	木 艹 {左上} 口
楊	木 日 一 {两撇}
楋	木 木 口 刂
楌	木 立 丿 彡
楍	木 口 口 口
楎	木 冖 車
楏	木 大 土 土
楐	木 田 人 {介下}
楑	木 癶 一 大
楒	木 田 心
楓	木 風
楕	木 {左上} 工 月
楖	木 彐 厶 卩
楘	予 丿 夊 木
楙	木 予 丿 木
楛	木 艹 古
楜	木 古 月
楟	木 {亮頭} 丁
楡	木 入 一 巜
楢	木 丷 酉
楤	木 勹 {两撇} 心
楥	木 爪 干 又
楧	木 艹 冂 大
楨	木 卜 貝
楩	木 亻 一 乂
楪	木 世 木
楬	木 日 勹 乚
業	业 羊 八
楯	木 ⺁ 十 目
楰	木 臼 人
楲	木 戊 一 女
楳	木 卄 二 木
楴	木 亠 丷 巾
極	木 了 口 一
楶	二 欠 口 木
楺	木 予 丿 木
楻	木 白 王
楽	白 二 二 木
楾	木 白 水
楿	木 禾 日
榁	木 宀 至
榃	木 木 田
榅	木 日 皿
榊	木 示 申
榋	木 彐 彐 彐
榌	木 飛
榎	木 丆 目 夊
榏	木 䒑 八 皿
榐	木 尸 艹 {畏下}
榑	木 甫 寸
榒	木 弓 二 二
榓	木 心 丿 皿
榖	{穀頭} 一 木
榗	木 丌 䒑 日
榙	木 艹 合
榚	木 羊 灬
榝	木 乂 木 殳
榞	木 厂 白 小
榟	木 宀 辛
榠	木 冖 日 八
榡	木 龶 糸
榢	木 宀 豕
榣	木 爪 缶
榤	木 夕 ヰ 木
榥	木 日 小 兀
榦	十 早 人 木
榩	木 {虎头} 文
榪	木 馬
榬	木 土 口 𧘇
榮	火 火 冖 木
榯	木 日 土 寸
榰	木 耂 匕 日
榲	木 囗 人 皿
榳	木 广 壬 廴
榵	木 艹 耳
榶	木 广 肀 口
榸	木 土 里
榹	木 ⺁ 虎
榺	月 丷 夫 木
榼	木 土 厶 皿
榽	木 爪 幺 大
榾	木 骨
榿	木 山 一 䒑
槀	高 木
槂	木 子 丿 糸
槃	舟 殳 木
槄	木 爪 臼
槅	木 一 口 丨
槆	木 艹 勹 日
槇	木 匕 目 八
槈	木 辰 寸
槉	木 疒 矢
構	木 {冓上} 冂 土
槍	木 人 丶 口
槏	木 䒑 彐 八
槑	口 木 口 木
槒	木 亠 幺 田
槓	木 工 貝
槕	木 卜 日 木
槖	士 冖 石 木
槗	木 {左上} 口 口
様	木 羊 水
槙	木 十 且 八
槚	木 西 贝
槜	木 隹 乃
槝	木 {鳥上} 山
槞	木 立 电
槡	木 又 又 木
槢	木 习 习 白
槣	木 宀 大 口
槤	木 車 辶
槥	木 丰 丰 彐
槦	木 广 肀 月
槧	車 斤 木
槨	木 {京頭} 子 阝
槩	彐 厶 匚 木
槪	木 白 匕 儿
槫	木 {專上} 寸
槬	木 大 一 瓜
槮	木 厶 厶 彡
槯	木 山 隹
槰	木 夊 丰 辶
槱	木 酉 灬
槳	爿 月 寸 木
槴	木 户 口 巴
槵	木 口 口 心
槶	木 囗 戈 一
槷	土 八 土 木
槸	木 土 八 丶
槹	木 白 二 十
槺	木 广 彐 水
槻	木 夫 見
槼	夫 見 木
槾	木 日 罒 又
樀	木 亠 丷 古
樁	木 𡗗 臼
樂	白 幺 幺 木
樃	木 丶 彐 月
樄	木 阝 木 日
樅	木 彳 人 龰
樆	木 文 凵 厶
樇	木 亻 丨 月
樈	木 立 日 儿
樉	木 大 乂 乂
樋	木 マ 用 辶
樌	木 {母框} 十 貝
樍	木 龶 貝
樎	木 宀 亻 日
樏	木 田 糸
樐	木 鹵
樑	木 氵 刀 木
樒	木 宀 心 山
樓	木 口 十 女
樔	木 巛 日 木
樕	木 木 口 欠
樖	合 木 丁 口
標	木 西 示
樚	木 鹿
樛	木 习 习 彡
樜	木 广 卄 灬
樝	木 {虎头} 且
樞	木 匚 口 口
樠	木 卄 一 入
樢	木 鳥
樣	木 羊 丶 水
樤	木 亻 丨 木
樥	木 艹 夊 丰
樦	木 竹 丶 王
樧	木 乂 木 殳
権	木 𠂉 一 隹
樫	木 臣 又 土
樬	木 {囟框} 夊 心
樭	木 其 土
樮	木 西 火
樰	木 雨 彐
樲	木 弋 二 貝
樳	木 彐 工 寸
樴	木 立 日 戈
樶	木 日 耳 又
樷	木 木 耳 又
樸	木 业 䒑 夫
樹	木 士 口 寸
樺	木 艹 干 龷
樻	木 口 丄 貝
樼	木 尸 子 子
樿	木 口 口 十
橀	木 亠 厶 皿
橁	木 竹 勹 日
橂	木 丷 酉 大
橃	木 癶 弓 殳
橅	木 𠂉 卌 灬
橆	𠂉 卌 一 木
橈	木 土 土 兀
橉	木 米 夕 ヰ
橊	木 丌 匚 田
橋	木 夭 口 口
橌	木 門 月
橍	木 門 王
橎	木 丿 米 田
橏	木 羊 䒑 口
橑	木 大 丷 小
橒	木 雨 二 厶
橓	木 爪 冖 ヰ
橔	木 {京頭} 子 夊
橕	木 尚 牙
橖	木 尚 木
橗	木 艹 日 月
橚	木 肀 片 一
橜	厂 䒑 屮 木
橝	木 西 早
橞	木 {專上} 心
機	木 幺 幺 人
橠	木 亠 夕 𧘇
橢	木 阝 {左上} 月
橣	木 宀 心 用
橤	心 心 心 木
橦	木 立 里
橧	木 丷 日 日
橨	木 十 卄 貝
橩	木 火 火 几
橪	木 月 犬 灬
橫	木 艹 二 八
橬	木 匚 儿 日
橭	木 古 辛
橮	木 卯 貝
橯	木 火 火 力
橰	木 自 二 十
橲	木 士 口 口
橳	木 月 丷 力
橴	木 止 匕 糸
橵	木 龷 月 夊
橶	木 十 早 戈
橷	木 白 丬 儿
橸	木 日 日 日
橺	木 門 日
橻	木 丑 丑 丑
橽	木 土 羊 辶
橾	木 口 口 木
橿	木 一 田 一
檁	木 亠 囗 禾
檂	木 冂 龷 辰
檃	阝 爪 工 木
檅	木 止 戊 小
檆	木 火 火 口
檇	木 隹 {雋下}
檈	木 罒 一 𧘇
檉	木 耳 口 王
檊	木 十 早 干
檋	木 龷 八 車
檌	木 罒 非
檍	木 立 日 心
檏	木 业 羊 八
檒	木 木 風
檓	木 臼 工 殳
檔	木 尚 田
檕	車 凵 殳 木
檖	木 䒑 豕 辶
檘	木 尸 口 辛
檙	木 目 爿 片
檚	木 木 木 龰
檛	木 咼 辶
檜	木 人 一 日
檝	木 口 耳 戈
檞	木 冖 用 牛
檟	木 西 貝
檡	木 罒 土 十
檢	木 僉
檣	木 土 人 口
檤	木 䒑 自 辶
檥	木 羊 丿 戈
檦	木 西 示 刂
檧	木 艹 勹 心
檨	木 羊 二 欠
檪	木 白 二 木
檭	木 金 艮
檮	木 士 乛 寸
檯	木 士 口 至
檰	木 糹 白 巾
檱	木 竹 其
檲	木 囗 {專上} 寸
檳	木 宀 一 貝
檴	木 艹 隹 又
檵	木 幺 幺 乚
檶	木 大 匚 口
檷	木 一 八 乂
檸	木 宀 心 丁
檹	木 方 𠂉 口
檺	木 {亮頭} 豕
檻	木 臣 {⺮右} 皿
檼	木 爪 工 心
檽	木 雨 而
檾	火 火 冖 木
檿	厂 日 月 木
櫀	木 其 糸
櫁	木 宀 心 虫
櫂	木 习 习 隹
櫃	木 匚 口 貝
櫄	木 千 黑
櫅	木 亠 丷 二
櫆	木 鬼 ⺀ 十
櫇	木 皮 丆 貝
櫈	木 癶 一 几
櫉	木 厂 士 寸
櫊	木 門 夊 口
櫋	木 自 穴 方
櫌	木 丆 月 夊
櫍	木 斤 斤 貝
櫎	木 广 龷 八
櫏	木 西 大 辶
櫐	田 田 田 木
櫑	木 田 田 田
櫒	木 艹 {祭上} 示
櫓	木 魚 日
櫔	木 厂 艹 禺
櫕	木 夫 夫 貝
櫖	木 {虎头} 田 心
櫗	木 艹 罒 丶
櫘	木 丰 丰 心
櫙	木 艹 匚 口
櫚	木 門 口 口
櫛	木 竹 彐 卩
櫜	十 口 冖 木
櫝	木 士 罒 貝
櫞	木 糹 {互中} 豕
櫟	木 白 幺 木
櫠	木 广 癶 殳
櫡	木 竹 耂 日
櫢	木 口 十 夊
櫣	木 艹 車 辶
櫤	木 竹 䒑 刂
櫥	木 广 士 寸
櫦	木 {鹿上} 乛 夊
櫧	木 言 耂 日
櫨	木 {虎头} 田 皿
櫩	木 門 冖 臼
櫪	木 厂 禾 止
櫫	豕 耂 日 木
櫬	木 立 木 見
櫭	木 彐 厶 一
櫮	木 王 口 口
櫯	木 魚 禾
櫰	木 亠 罒 𧘇
櫱	屮 𠂤 辛 木
櫲	木 予 冖 豕
櫳	木 立 月 {龍右}
櫴	木 木 口 貝
櫵	木 艹 隹 灬
櫶	木 宀 丰 心
櫷	木 丿 {龜下}
櫸	木 臼 丂 キ
櫹	木 艹 肀 一
櫺	木 雨 口 口
櫻	木 貝 貝 女
櫼	木 人 人 一
櫽	阝 爪 工 木
櫾	木 爪 缶 糸
櫿	木 火 火 口
欀	木 {京頭} 口 𧘇
欁	木 冂 龷 木
欂	木 艹 氵 寸
欃	木 冖 口 丶
欄	木 門 木 丷
欅	木 臼 丂 手
欆	木 隹 隹 又
欇	木 耳 耳 耳
欈	木 山 隹 口
欉	木 业 䒑 又
權	木 艹 口 隹
欋	木 目 目 隹
欌	木 艹 戈 臣
欍	木 艹 隹 臼
欎	木 乂 乂 寸
欏	木 罒 糹 隹
欐	木 一 {冂丶} 鹿
欑	木 ⺧ 儿 貝
欒	言 糹 糹 木
欓	木 尚 黑
欔	木 目 目 又
欕	木 口 口 夊
欖	木 臣 {⺮右} 見
欗	木 艹 門 丷
欘	木 尸 水 虫
欙	木 田 田 糸
欚	木 {互中} 豕 虫
欛	木 雨 革 月
欜	木 十 口 𧘇
欝	木 乂 乂 寸
欞	木 雨 口 人
欟	木 艹 口 見
欥	日 欠
欦	人 丶 乛 欠
欨	勹 口 欠
欩	刀 口 欠
欪	屮 凵 欠
欫	𠂉 一 止 欠
欬	亥 欠
欭	囗 大 欠
欮	䒑 屮 欠
欯	士 口 欠
欰	丿 皿 欠
欱	合 欠
欳	卜 冊 欠
欴	丶 彐 厶 欠
欵	匕 矢 欠
欶	木 口 欠
欸	厶 矢 欠
欻	火 火 欠
欼	又 又 又 欠
欽	金 欠
欿	冖 臼 欠
歀	木 示 欠
歁	其 乚 欠
歂	山 而 欠
歄	咼 欠
歅	西 土 欠
歈	人 一 月 欠
歊	高 欠
歋	⺁ 虎 欠
歍	烏 欠
歎	卄 一 口 欠
歏	革 二 欠
歐	匚 口 口 欠
歑	{虎头} 丿 丷 欠
歒	亠 丷 冂 欠
歓	𠂉 一 隹 欠
歔	{虎头} 业 欠
歕	十 卄 貝 欠
歖	士 口 䒑 欠
歗	肀 片 爿 欠
歘	火 火 火 欠
歚	羊 䒑 口 欠
歛	僉 欠
歜	罒 勹 虫 欠
歝	罒 土 䒑 欠
歞	日 幺 幺 欠
歟	臼 丂 丄 欠
歠	又 又 又 欠
歡	艹 口 口 欠
歨	止 龰
歩	止 小 丿
歫	止 匚 コ
歬	止 舟
歭	止 土 寸
歮	止 止 止
歯	止 米 凵
歰	刀 丶 刀 止
歱	止 千 里
歲	止 戊 一 小
歳	止 戊 一 小
歴	厂 木 木 止
歵	止 龶 貝
歶	止 匕 禺
歷	厂 禾 禾 止
歸	𠂤 止 彐 巾
歺	卜 夕
歽	一 夕 斤
歾	一 夕 勹 {两撇}
歿	一 夕 勹 又
殀	一 夕 夭
殅	一 夕 生
殈	一 夕 丿 皿
殌	一 夕 一 工
殎	一 夕 大 人
殏	一 夕 一 丶
殐	一 夕 木 口
殑	一 夕 古 儿
殔	一 夕 彐 水
殕	一 夕 立 口
殗	一 夕 大 电
殘	一 夕 戈 戈
殙	一 夕 {卬左} 日
殜	一 夕 世 木
殝	一 夕 𡗗 禾
殞	一 夕 口 貝
殟	一 夕 日 皿
殠	一 夕 自 犬
殢	一 夕 卌 巾
殣	一 夕 革 二
殤	一 夕 𠂉 {两撇}
殥	一 夕 宀 八
殦	一 夕 鳥
殧	一 夕 {京頭} 尤
殨	一 夕 口 貝
殩	一 夕 卜 米
殫	一 夕 口 十
殬	一 夕 罒 十
殭	一 夕 一 一
殮	一 夕 僉
殯	一 夕 宀 貝
殰	一 夕 士 貝
殱	一 夕 十 一
殲	一 夕 人 一
殶	丶 王 殳
殸	士 {眉上} 殳
殹	匚 矢 殳
殺	乂 木 殳
殻	{穀頭} 几
殼	{穀頭} 一 几
殽	乂 {左上} 月 殳
殾	耂 日 殳
毀	臼 土 殳
毃	高 殳
毄	車 口 殳
毆	匚 口 口 殳
毇	臼 米 殳
毈	卯 丶 丶 殳
毉	匚 矢 殳 人
毊	士 {眉上} 殳 口
毌	{母框} 十
毎	𠂉 {母框} 十
毐	士 {母框} {左上}
毑	母 也
毘	田 匕 匕
毚	冖 口 匕 丶
毜	毛 小
毝	毛 彡
毞	匕 匕 毛
毟	小 丿 毛
毠	力 口 毛
毢	毛 西
毣	习 习 毛
毤	八 厶 儿 毛
毥	毛 勹 日
毦	耳 毛
毧	毛 戈 {左上}
毨	毛 ⺧ 儿
毩	毛 米
毬	毛 一 水 丶
毭	一 口 䒑 毛
毮	扌 小 丿 毛
毰	毛 立 口
毱	毛 勹 米
毲	又 又 又 毛
毴	毛 非
毶	毛 厶 大 彡
毷	冂 二 目 毛
毸	毛 田 心
毺	毛 人 一 刂
毻	{左上} 工 月 毛
毼	日 勹 人 毛
毾	日 习 习 毛
毿	厶 厶 厶 毛
氀	口 十 口 毛
氁	毛 艹 日 大
氂	未 夊 厂 毛
氃	立 里 毛
氄	予 丿 冂 毛
氈	亠 囗 口 毛
氉	口 口 口 毛
氊	毛 亠 囗 一
氋	艹 冖 一 毛
氌	毛 魚 日
氎	田 田 田 毛
氒	{卬左} 七 十
気	气 乂
氜	气 日
氝	气 冂 人
氞	气 一 冂 人
氠	气 申
氣	气 米
氥	气 西
氫	气 一 巛 工
氬	气 一 {亞下}
氭	气 木 日
氱	气 日 一 {两撇}
氳	气 囗 人 皿
氶	乛 水
氷	丶 水
氹	乙 水
氺	水
氻	氵 力
氼	水 人
氾	氵 㔾
氿	氵 九
汃	氵 八
汄	氵 人
汅	氵 丂
汈	氵 乛 一
汋	氵 勹 丶
汌	氵 川
汍	氵 九 丶
汎	氵 几 丶
汏	氵 大
汑	氵 丿 七
汒	氵 亡
汓	氵 子
汖	山 水
汘	氵 千
汙	氵 一 {于下}
汚	氵 二 ㇉
汢	氵 土
汣	氵 冖 丶
汥	氵 十 又
汦	氵 {卬左} 七
汧	氵 一 卄
汫	氵 二 {介下}
汬	二 {介下} 水
汭	氵 冂 人
汮	氵 勹 二
汯	氵 {左上} 厶
汱	氵 犬
汳	氵 ⺁ 又
汵	氵 人 丶 乛
汷	氵 夊
汸	氵 方
決	氵 コ 人
汻	氵 𠂉 十
汼	氵 牛
汿	氵 予
沀	水 予
沄	氵 二 厶
沇	氵 厶 儿
沊	冖 儿 水
沋	氵 尤
沍	氵 一 彑
沎	氵 亻 匕
沑	氵 丑
沒	氵 勹 又
沕	氵 勹 {两撇}
沖	氵 口 丨
沗	一 大 水
沘	氵 匕 匕
沚	氵 止
沜	氵 片
沝	水 水
沞	氵 一 巾
沠	氵 爪
沢	氵 尸 乀
沨	氵 几 乂
沬	氵 未
沯	水 石
沰	氵 石
沴	氵 人 彡
沵	氵 冖 小
沶	氵 示
沷	氵 {左上} 又 丶
沺	氵 田
泀	氵 乛 一 口
況	氵 口 儿
泂	氵 冂 口
泃	氵 勹 口
泆	氵 丿 夫
泇	氵 力 口
泈	氵 夊 ⺀
泋	氵 十 卄
泍	氵 木 一
泎	氵 𠂉 {乍下}
泏	氵 屮 凵
泑	氵 幺 力
泒	氵 瓜
泘	氵 丿 丷 {于下}
泙	氵 干 丷
泚	氵 止 匕
泜	氵 {卬左} 七 丶
泝	氵 斤 丶
泟	氵 一 止
泤	氵 乚 丶 人
泦	氵 尸 九
泧	氵 戈 乚
泩	氵 生
泬	氵 穴
泭	氵 亻 寸
泲	氵 丿 ㇉ 丿
泴	水 皿
泹	氵 日 一
泿	氵 艮
洀	氵 舟
洂	氵 亦
洃	氵 {左上} 火
洅	氵 王 冂
洆	氵 乛 水 一
洈	氵 冖 厂 㔾
洉	氵 ⺁ 一 口
洊	氵 {左上} 丨 子
洍	氵 臣
洏	氵 而
洐	氵 彳 亍
洑	氵 亻 犬
洓	氵 木 冂
洔	氵 土 寸
洕	氵 八 月
洖	氵 口 一 大
洘	氵 耂 丂
洜	夊 口 水
洝	氵 宀 女
洟	氵 大 弓
洠	氵 厶 牛
洡	氵 丰 八
洢	氵 亻 彐 丿
洣	氵 米
洤	氵 人 王
洦	氵 丆 日
洨	氵 亠 八 乂
洩	氵 电 丿
洬	氵 几 一 夕
洭	氵 匚 王
洯	丰 刀 水
洰	氵 匚 コ
洴	氵 䒑 卄
洶	氵 勹 乂 凵
洷	氵 至
洸	氵 小 兀
洺	氵 夕 口
洿	氵 大 一 丂
浀	氵 冂 龷
浂	氵 䒑 大
浄	氵 冖 彐 亅
浉	氵 リ 一 巾
浌	氵 亻 戈
浐	氵 立 丿
浕	氵 尸 乀 ⺀
浖	氵 爪 寸
浗	氵 一 水 丶
浘	氵 尸 毛
浛	氵 人 丶 口
浝	氵 尤 彡
浟	氵 亻 丨 夊
浡	氵 十 冖 子
浢	氵 一 口 䒑
浤	氵 宀 {左上} 厶
浥	氵 口 巴
浧	氵 口 王
浨	氵 宀 木
浫	氵 冖 八 干
浬	氵 里
浭	氵 一 日 乂
浰	氵 禾 刂
浱	氵 辰
浲	氵 夊 丰
浳	氵 弋 月
浵	氵 ⺆ 亠 彡
浶	氵 宀 牛
浹	氵 大 人 人
浺	氵 忄 口 丨
浻	氵 冂 八 口
浽	氵 爪 女
浾	氵 土 {介下} 八
浿	氵 貝
涀	氵 見
涁	氵 木 彡
涃	氵 囗 木
涄	氵 由 丂
涆	氵 日 干
涇	氵 一 巛 工
涊	氵 刀 丶 心
涋	氵 宀 犬
涍	氵 耂 子
涏	氵 壬 廴
涐	氵 丿 扌 戈
涒	氵 彐 丿 口
涖	氵 亻 立
涗	氵 八 口 儿
涘	氵 厶 矢
涙	氵 户 大
涚	氵 丷 口 儿
涜	氵 士 冖 儿
涢	氵 口 贝
涥	氵 {京頭} 了
涬	氵 土 䒑 十
涭	氵 爪 冖 又
涰	氵 又 又 又
涱	氵 長
涳	氵 穴 工
涴	氵 宀 夕 㔾
涶	氵 壬 龷
涷	氵 木 日
涹	氵 禾 女
涺	氵 尸 古
涻	氵 人 干 口
涼	氵 {京頭} 小
涽	氵 {卬左} 七 日
涾	氵 水 日
淁	氵 立 女
淂	氵 日 一 寸
淃	氵 丷 夫 㔾
淈	氵 尸 屮 凵
淉	氵 日 木
淊	氵 冖 臼
淍	氵 ⺆ 土 口
淎	氵 𡗗 キ
淏	氵 日 一 大
淐	氵 日 日
淒	氵 十 彐 女
淓	氵 艹 方
淔	氵 十 且
淕	氵 土 八 土
淗	氵 勹 米
淚	氵 户 犬
淛	氵 牛 冂 刂
淜	氵 月 月
淟	氵 冂 龷 八
淢	氵 戈 口 一
淣	氵 臼 儿
淥	氵 彑 水
淧	氵 宀 心 丿
淨	氵 爪 彐 亅
淩	氵 土 八 夊
淪	氵 人 一 冊
淭	氵 户 木
淯	氵 亠 厶 月
淰	氵 人 丶 心
淲	氵 虎
淴	氵 勹 {两撇} 心
淵	氵 片 爿 一
淶	氵 來
淸	氵 龶 冂 丄
淺	氵 戈 戈
淽	氵 艹 止
淾	金 水
淿	氵 白 巾
渀	氵 大 十 卄
渁	氵 水 水
渂	氵 日 文
渃	氵 艹 {左上} 口
渄	氵 非
渆	氵 䒑 卄 刂
渇	氵 日 勹 匕
済	氵 文 {介下} 二
渉	氵 止 小 丿
渋	氵 止 二 二
渏	氵 大 丁 口
渒	氵 {卑上} 十
渓	氵 爪 夫
渕	氵 䒑 大 刂
渘	氵 予 丿 木
渙	氵 冖 冂 大
減	氵 戊 一 口
渜	氵 而 大
渞	氵 䒑 自
渟	氵 {亮頭} 丁
渢	氵 風
渦	氵 咼
渧	氵 亠 丷 巾
渨	氵 田 {畏下}
渪	氵 丿 虫 冂
測	氵 貝 刂
渮	氵 艹 丁 口
渰	氵 合 卄
渱	氵 虫 工
渳	氵 弓 耳
渵	氵 艹 田
渶	氵 艹 冂 大
渷	氵 亠 八 儿
渹	氵 勹 言
渻	氵 小 丿 目
渼	氵 羊 大
渽	氵 十 戈 口
渾	氵 冖 車
渿	氵 木 示
湀	氵 癶 一 大
湁	氵 扌 合
湂	氵 口 口 丂
湅	氵 木 囗 丷
湆	氵 立 日
湇	氵 立 月
湈	氵 卄 二 木
湉	氵 忄 舌
湊	氵 𡗗 一 大
湋	氵 韋
湌	氵 食
湏	氵 丆 貝
湐	氵 木 白
湑	氵 乛 龰 月
湒	氵 口 耳
湕	氵 彐 キ 廴
湗	氵 土 土 寸
湙	氵 亦 大
湚	氵 儿 幺 月
湜	氵 日 一 龰
湝	氵 匕 匕 白
湞	氵 卜 貝
湠	氵 山 {左上} 火
湡	氵 禺
湢	氵 一 口 田
湣	氵 巳 七 日
湤	氵 方 𠂉 也
湥	氵 穴 犬
湦	氵 日 生
湧	氵 マ 用 力
湨	氵 目 犬
湩	氵 千 里
湪	氵 {互中} 豕
湬	禾 火 水
湭	氵 丷 酉
湯	氵 日 一 {两撇}
湰	氵 夊 一 生
湱	氵 丰 石
湲	氵 爪 干 又
湳	氵 十 冂 十
湴	氵 䒑 业
湵	氵 羊 冖 丶
湶	氵 白 水
湷	氵 𡗗 日
湸	氵 {亮頭} 几
湹	氵 厂 里
湺	氵 亻 口 木
湻	氵 {京頭} 日
湼	氵 臼 工
湽	氵 巛 一 田
満	氵 龷 冂 山
溁	氵 艹 冖 木
溂	氵 木 口 刂
溄	氵 山 夊 キ
溇	氵 米 女
溈	氵 丶 {爲下}
溊	氵 尸 二 又
溋	氵 乃 又 皿
溌	氵 癶 二 儿
溍	氵 丌 䒑 日
溎	氵 木 土 土
溑	氵 小 貝
溒	氵 土 口 𧘇
溓	氵 䒑 彐 八
溔	氵 羊 灬
溕	氵 冖 一 豕
準	氵 隹 十
溗	氵 禾 丬 匕
溙	氵 𡗗 水
溚	氵 艹 合
溛	氵 穴 瓜
溝	氵 {冓上} 冂 土
溞	氵 又 丶 虫
溠	氵 羊 工
溡	氵 日 土 寸
溣	氵 亻 人 冊
溤	氵 馬
溦	氵 山 一 夊
溨	氵 十 戈 木
溩	氵 烏
溫	氵 囗 人 皿
溬	氵 羊 乚 厶
溭	氵 田 八 夊
溮	氵 𠂤 一 巾
溰	氵 山 一 䒑
溳	氵 口 貝
溵	氵 ⺁ 彐 殳
溸	氵 龶 糸
溹	氵 十 冖 糸
溼	氵 一 幺 土
溾	氵 鬼
溿	氵 田 丷 キ
滀	氵 亠 幺 田
滃	氵 八 厶 习
滄	氵 人 丶 口
滅	氵 戊 一 火
滆	氵 一 口 丨
滈	氵 高
滉	氵 日 小 兀
滊	氵 气 米
滌	氵 亻 丨 木
滍	氵 屮 一 虫
滎	火 火 冖 水
滐	氵 夕 ヰ 木
滒	氵 丁 口 口
滖	氵 {京頭} 一 𧘇
滘	氵 冖 八 口
滙	氵 匚 隹
滛	氵 爪 缶
滜	氵 白 大 十
滝	氵 立 电
滣	氵 辰 口
滧	氵 亠 八 夊
滪	氵 予 丆 贝
滫	氵 亻 丨 月
滬	氵 户 口 巴
滭	氵 日 卄 キ
滮	氵 虎 彡
滯	氵 卌 一 巾
滰	氵 立 日 儿
滱	氵 宀 一 又
滲	氵 厶 厶 彡
滳	氵 亠 丷 口
滵	氵 宀 心 山
滶	氵 龶 勹 夊
滷	氵 鹵
滸	氵 言 𠂉 十
滺	氵 亻 丨 心
滻	氵 立 丿 生
滼	氵 木 木 丶
滽	氵 广 肀 月
滾	氵 亠 八 𧘇
滿	氵 卄 一 入
漀	士 {眉上} 殳 水
漁	氵 魚
漃	氵 宀 上 又
漄	氵 山 厂 土
漅	氵 巛 日 木
漇	氵 彳 止 龰
漈	氵 {祭上} 示
漊	氵 口 十 女
漋	氵 阝 夊 生
漌	氵 革 二
漍	氵 囗 戈 一
漎	氵 彳 人 龰
漐	土 䒑 十 水
漑	氵 白 匕 儿
漒	氵 弓 口 虫
漖	氵 耂 子 夊
漗	氵 {囟框} 夊 心
漘	氵 辰 月
漙	氵 {專上} 寸
漚	氵 匚 口 口
漛	氵 丷 夫 水
漜	氵 木 木 土
漝	氵 习 习 白
漞	氵 爪 見
漟	氵 尚 土
漡	氵 𠂉 日 {两撇}
漢	氵 卄 一 夫
漣	氵 車 辶
漥	氵 穴 土 土
漦	未 夊 厂 水
漧	氵 十 早 乙
漨	氵 夊 丰 辶
漬	氵 龶 貝
漮	氵 广 彐 水
漰	氵 山 月 月
漲	氵 弓 長
漴	氵 山 宀 示
漵	氵 人 一 夊
漷	氵 {京頭} 子 阝
漸	氵 車 斤
漹	氵 一 止 灬
漺	氵 大 乂 乂
漻	氵 习 习 彡
漼	氵 山 隹
漽	氵 尸 水 牛
漿	爿 月 寸 水
潀	氵 罒 亻 人
潁	匕 水 丆 貝
潂	氵 山 䒑 业
潃	氵 彳 夊 月
潄	氵 木 口 夊
潅	氵 𠂉 一 隹
潈	氵 罒 豕
潉	氵 山 日 匕
潊	氵 人 一 又
潌	氵 穴 至
潎	氵 丷 巾 夊
潏	氵 予 丿 口
潐	氵 隹 灬
潑	氵 癶 弓 殳
潒	氵 冖 口 豕
潓	氵 {專上} 心
潔	氵 丰 刀 糸
潕	氵 𠂉 卌 灬
潖	氵 王 王 巴
潗	氵 隹 木
潙	氵 爪 {爲下}
潚	氵 肀 片 一
潛	氵 匚 儿 日
潝	氵 合 习 习
潟	氵 臼 勹 灬
潠	氵 巳 巳 八
潡	氵 {京頭} 子 夊
潣	氵 門 文
潤	氵 門 王
潥	氵 西 米
潧	氵 丷 日 日
潨	氵 丿 罒 二
潩	氵 田 龷 八
潪	氵 矢 口 日
潫	氵 丷 夫 糸
潬	氵 口 口 十
潯	氵 彐 工 寸
潰	氵 口 丄 貝
潱	氵 士 冖 䒑
潳	氵 尸 耂 日
潵	氵 龷 月 夊
潶	氵 黑
潷	氵 竹 彐 キ
潹	氵 木 木 木
潻	氵 禾 人 水
潽	氵 䒑 业 日
潾	氵 米 夕 ヰ
潿	氵 囗 韋
澀	氵 刀 丶 止
澁	氵 止 止 止
澂	氵 山 一 夊
澃	彡 丆 貝 水
澅	氵 彐 土 一
澆	氵 土 土 兀
澇	氵 火 火 力
澊	氵 丷 酉 寸
澋	氵 日 {京頭} 小
澏	氵 口 口 山
澐	氵 雨 二 厶
澑	氵 丌 匚 田
澒	氵 工 丆 貝
澓	氵 彳 𠂉 夊
澔	氵 白 ⺧ 口
澕	氵 艹 干 龷
澖	氵 門 木
澗	氵 門 日
澘	氵 木 木 日
澙	氵 臼 丂 灬
澚	氵 {向框} 米 丂
澛	氵 鱼 日
澝	氵 宀 心 用
澞	氵 {虎头} 口 大
澟	氵 亠 囗 禾
澠	氵 黽
澢	氵 尚 田
澣	氵 十 早 干
澤	氵 罒 土 十
澥	氵 冖 用 牛
澦	氵 予 丆 貝
澨	氵 竹 工 人
澩	臼 乂 乂 水
澪	氵 雨 人 マ
澫	氵 艹 禺
澬	氵 二 欠 貝
澭	氵 亠 {纟上} 隹
澮	氵 人 一 日
澯	氵 卜 夕 米
澰	氵 僉
澱	氵 尸 龷 殳
澲	氵 业 羊 八
澴	氵 罒 一 𧘇
澵	氵 立 木 斤
澷	氵 日 罒 方
澸	氵 戊 一 心
澺	氵 立 日 心
澻	氵 䒑 豕 辶
澼	氵 尸 口 辛
澽	氵 {虎头} 豕
澾	氵 土 羊 辶
澿	氵 木 木 示
濁	氵 罒 勹 虫
濃	氵 冂 龷 辰
濄	氵 咼 辶
濅	氵 宀 彐 又
濆	氵 十 卄 貝
濇	氵 土 人 口
濈	氵 口 耳 戈
濊	氵 止 戊 小
濋	氵 木 木 龰
濌	千 里 水 日
濍	氵 艹 勹 心
濎	氵 目 爿 片
濏	氵 王 王 丿
濐	氵 日 耂 日
濓	氵 立 丿 八
濔	氵 一 八 乂
濕	氵 日 幺 灬
濖	氵 罒 耂 日
濗	氵 艹 日 巾
濘	氵 宀 心 丁
濙	氵 火 火 火
濚	氵 火 火 木
濛	氵 艹 冖 豕
濜	氵 肀 一 皿
濝	氵 其 糸
濟	氵 亠 丷 二
濢	氵 习 习 十
濣	氵 十 早 十
濤	氵 士 乛 寸
濥	氵 夕 宀 八
濦	氵 爪 工 心
濧	氵 业 羊 寸
濨	氵 䒑 幺 心
濩	氵 艹 隹 又
濪	氵 龶 月 巴
濫	氵 臣 {⺮右} 皿
濬	氵 卜 冖 目
濭	氵 艹 土 皿
濰	氵 糹 隹
濱	氵 宀 一 貝
濲	氵 {穀頭} 一 木
濳	氵 ⺧ 儿 日
濴	氵 火 火 水
濵	氵 宀 {眉上} 貝
濶	氵 門 舌
濷	水 氵 卄 入
濸	氵 艹 人 口
濹	氵 黑 土
濺	氵 貝 戈 戈
濻	氵 阝 口 貝
濼	氵 白 幺 木
濽	氵 夫 夫 貝
濾	氵 {虎头} 田 心
濿	氵 厂 艹 禺
瀀	氵 丆 月 夊
瀁	氵 䒑 夫 艮
瀂	氵 魚 日
瀃	氵 貝 日 {两撇}
瀄	氵 竹 彐 卩
瀅	氵 火 火 丶
瀆	氵 士 罒 貝
瀇	氵 广 龷 八
瀈	氵 习 习 車
瀉	氵 宀 臼 灬
瀊	氵 舟 殳 皿
瀋	氵 宀 丿 田
瀌	氵 鹿 灬
瀍	氵 广 里 土
瀎	氵 艹 罒 丶
瀏	氵 卯 金 刂
瀐	氵 十 戈 一
瀒	氵 來 一 口
瀓	氵 {微上} 一 王
瀔	氵 {穀頭} 一 禾
瀕	氵 止 小 貝
瀖	氵 雨 隹
瀗	氵 宀 丰 心
瀘	氵 {虎头} 田 皿
瀙	氵 立 木 見
瀜	氵 一 口 虫
瀝	氵 厂 禾 止
瀞	氵 龶 月 亅
瀟	氵 艹 肀 一
瀠	氵 火 火 糸
瀡	氵 阝 {左上} 辶
瀢	氵 口 丄 辶
瀤	氵 亠 罒 𧘇
瀥	氵 习 习 高
瀦	氵 豕 耂 日
瀧	氵 立 月 {龍右}
瀨	氵 木 口 貝
瀩	氵 禾 几 貝
瀪	𠂉 母 夊 水
瀫	氵 {穀頭} 一 糸
瀬	氵 木 口 貝
瀭	氵 車 人 刂
瀮	氵 雨 木 木
瀯	氵 火 火 口
瀰	氵 弓 一 乂
瀱	氵 罒 厂 刂
瀲	氵 僉 夊
瀳	氵 艹 {鹿上} 灬
瀴	氵 貝 貝 女
瀶	氵 臣 𠂉 口
瀷	氵 习 习 八
瀸	氵 人 人 一
瀺	氵 冖 口 丶
瀻	氵 十 戈 八
瀼	氵 {京頭} 口 𧘇
瀽	氵 宀 {冓上} 足
瀾	氵 門 木 丷
瀿	氵 𠂉 母 糸
灀	氵 雨 木 目
灁	氵 門 白 水
灂	氵 爪 罒 寸
灃	氵 山 丰 䒑
灄	氵 耳 耳 耳
灅	氵 田 田 土
灆	氵 艹 臣 皿
灇	氵 业 䒑 又
灈	氵 目 目 隹
灉	氵 巛 口 隹
灊	氵 匚 儿 丨
灋	氵 {鹿上} 丂 厶
灍	氵 門 䒑 欠
灎	氵 冂 龷 皿
灐	氵 火 火 金
灑	氵 一 {冂丶} 鹿
灒	氵 ⺧ 儿 貝
灓	言 糹 糹 水
灔	氵 冂 龷 巴
灕	氵 文 凵 隹
灖	氵 麻 非
灗	氵 虫 亠 一
灘	氵 卄 一 隹
灙	氵 尚 黑
灚	氵 臼 乂 見
灛	氵 門 口 十
灜	氵 {贏頭} 貝
灝	氵 日 {京頭} 貝
灟	氵 尸 水 虫
灠	氵 臣 {⺮右} 見
灡	氵 艹 門 丷
灢	氵 十 口 𧘇
灣	氵 言 糹 弓
灤	氵 言 糹 木
灥	白 水 白 水
灦	氵 日 幺 貝
灧	氵 山 丰 巴
灨	氵 立 早 貝
灩	氵 山 丰 皿
灪	氵 木 缶 彡
灮	火 儿
灱	火 刀
灲	火 刂
灳	勹 火
灴	火 工
灷	火 卄
灹	火 丿 七
灺	火 也
灻	土 火
災	巛 火
炁	匚 儿 灬
炂	火 八 厶
炃	八 刀 火
炄	火 丑
炆	火 文
炇	火 夊
炈	火 殳
炋	火 不
炌	火 人 {介下}
炍	火 ⺁ 又
炏	火 火
炐	火 丰
炑	火 木
炓	火 ⺀ 十
炗	卄 一 火
炘	火 斤
炚	日 火
炛	火 亻 匕
炞	火 亠 卜
炟	火 日 一
炠	火 甲
炡	火 一 止
炢	火 木 丶
炣	火 丁 口
炤	火 刀 口
炥	火 弓 {介下}
炦	火 {左上} 又 丶
炧	火 𠂉 也
炨	火 宀 匕
炩	火 人 丶 マ
炪	火 屮 凵
炰	勹 巳 灬
炲	火 厶 口
炴	火 冂 大
炵	火 夊 ⺀
炶	火 卜 口
為	丶 {爲下}
炾	火 口 儿
炿	火 丿 ⺆ 亠
烄	火 亠 八 乂
烅	火 丿 皿
烆	火 彳 亍
烇	火 人 王
烉	冖 冂 八 火
烋	亻 木 灬
烌	火 亻 木
烍	火 ⺧ 儿
烎	一 卄 火
烏	烏
烐	火 舟
烑	火 儿 二 二
烒	火 弋 工
烓	火 土 土
烔	火 冂 一 口
烕	戊 一 火
烖	十 戈 火
烗	火 亥
烚	火 合
烜	火 一 日 一
烝	乛 水 一 灬
烞	火 木 卜
烠	火 {左上} 月
烡	火 龷 八
烢	火 宀 丿 七
烣	火 {左上} 火
烥	火 臣
烪	火 䒑 大
烮	一 夕 刂 火
烰	火 爪 子
烱	火 冂 八 口
烲	扌 斤 火
烳	火 甫
烴	火 一 巛 工
烵	火 艹 勹 丶
烶	火 壬 廴
烸	火 𠂉 母
烺	火 丶 艮
烻	火 丿 止 廴
烼	火 豕
烾	火 火 土
烿	火 ⺆ 亠 彡
焀	火 八 人 口
焁	口 欠 火
焂	亻 丨 夊 火
焃	火 土 {介下} 八
焄	彐 丿 口 灬
焅	火 ⺧ 口
焆	火 口 月
焇	火 小 月
焈	户 巳 火
焋	爿 士 火
焌	火 厶 八 夊
焍	火 丷 弓 丿
焎	扌 斤 灬
焏	了 口 又 灬
焑	火 囗 木
焒	火 口 口
焔	火 冖 丨 日
焗	火 尸 乛 口
焛	門 火
焜	火 日 匕 匕
焝	火 {卬左} 七 日
焞	火 {京頭} 子
焟	火 龷 日
焠	火 亠 人 十
無	𠂉 卌 一 灬
焢	火 穴 工
焣	耳 又 灬
焤	广 亻 寸 火
焥	火 宀 夕 㔾
焧	火 八 厶 心
焨	火 冂 二 月
焩	火 月 月
焪	火 穴 弓
焫	火 艹 冂 人
焬	火 日 勹 {两撇}
焭	火 火 冖 几
焮	火 斤 欠
焲	火 亠 亻 乀
焳	火 隹
焴	火 亠 厶 月
焵	火 冂 䒑 山
焷	火 {卑上} 十
焸	日 日 火
焹	火 冂 䒑 亡
焺	火 日 丿 卄
焻	火 日 日
焼	火 十 卄 兀
焽	日 月 火
焾	火 人 丶 心
焿	火 广 彐 人
煀	火 尸 屮 凵
煁	火 其 乚
煂	火 革
煃	火 大 土 土
煄	火 千 里
煆	火 尸 二 又
煇	火 冖 車
煈	火 風
煉	火 木 囗 丷
煋	火 日 生
煍	火 禾 火
煏	火 一 口 田
煐	火 艹 冂 大
煑	耂 日 火
煒	火 韋
煓	火 山 而
煔	火 火 卜 口
煕	臣 巳 灬
煖	火 爪 干 又
煗	火 而 大
煘	火 戊 一 口
煙	火 西 土
煚	日 匚 コ 火
煛	目 目 火
煝	火 {眉上} 目
煟	火 田 月
煠	火 世 木
煡	火 彐 キ 廴
煢	火 火 冖 十
煣	火 予 丿 木
煥	火 冖 冂 大
煩	火 丆 貝
煪	火 丷 酉
煫	火 䒑 豕
煬	火 日 一 {两撇}
煭	巛 一 夕 灬
煯	火 匕 匕 白
煰	火 口 口 口
煱	火 咼
煴	火 日 皿
煵	火 十 冂 十
煶	火 日 一 龰
煷	火 {亮頭} 几
煹	火 {冓上} 冂 土
煻	火 广 肀 口
煼	火 勹 屮 屮
煾	火 囗 大 心
煿	火 甫 寸
熀	火 日 小 兀
熁	火 力 力 月
熂	火 气 米
熃	予 丿 夊 火
熅	火 囗 人 皿
熆	火 土 厶 皿
熇	火 高
熈	丿 臣 巳 灬
熉	火 口 貝
熋	厶 月 匕 火
熌	火 門 人
熍	火 宀 口 口
熎	火 爪 缶
熐	火 冖 日 八
熑	火 䒑 彐 八
熒	火 火 冖 火
熓	火 烏
熕	火 工 貝
熖	火 爪 臼
熗	火 人 丶 口
熚	火 日 卄 キ
熛	火 西 示
熜	火 {囟框} 夊 心
熝	火 鹿
熞	火 臣 又 土
熡	火 口 十 女
熢	火 夊 丰 辶
熣	火 山 隹
熤	火 习 习 立
熥	火 マ 用 辶
熦	火 小 隹
熧	彳 人 人 火
熩	火 户 口 巴
熪	火 禾 夕 夕
熫	火 广 卄 灬
熭	丰 丰 彐 火
熮	火 习 习 彡
熯	火 卄 一 夫
熰	火 匚 口 口
熱	土 八 土 灬
熲	匕 火 丆 貝
熴	火 山 日 匕
熶	火 日 耳 又
熷	火 丷 日 日
熸	火 匚 儿 日
熺	火 士 口 口
熻	火 合 习 习
熼	火 田 龷 八
熽	火 肀 片 一
熾	火 立 日 戈
熿	火 龷 由 八
燀	火 口 口 十
燁	火 艹 干 龷
燂	火 西 早
燄	冖 臼 火 火
燅	土 八 土 火
燆	火 夭 口 口
燇	火 丷 酉 寸
燈	火 癶 一 䒑
燉	火 {京頭} 子 夊
燊	火 火 火 木
燋	火 隹 灬
燌	火 十 卄 貝
燍	火 其 斤
燏	火 予 丿 口
燐	火 米 夕 ヰ
燑	火 立 里
燒	火 土 土 兀
燓	木 乂 乂 火
燖	火 彐 工 寸
燗	火 門 月
燘	火 門 文
燙	氵 日 一 火
燚	火 火 火 火
燛	臣 臣 火
燜	火 門 心
燝	火 日 {京頭} 小
燞	隹 欠 灬
營	火 火 冖 口
燡	火 罒 土 十
燢	臼 乂 乂 火
燣	火 亠 囗 禾
燤	火 艹 禺
燦	火 卜 夕 米
燨	火 羊 丿 戈
燩	火 白 方 夊
燪	火 艹 勹 心
燫	火 广 䒑 八
燬	火 臼 工 殳
燭	火 罒 勹 虫
燯	火 雨 人 マ
燰	火 爪 冖 夊
燱	火 立 日 心
燲	火 力 力 貝
燳	火 日 刀 灬
燴	火 人 一 日
燵	火 土 羊 辶
燶	火 冂 龷 辰
燷	火 亠 囗 示
燸	火 雨 而
燺	火 高 木
燻	火 千 黑
燼	火 肀 一 皿
燽	火 士 乛 寸
燾	士 乛 工 灬
燿	火 习 习 隹
爀	火 土 {介下} 八
爁	火 臣 {⺮右} 皿
爂	臼 冂 一 火
爃	火 火 火 木
爄	火 厂 艹 禺
爅	火 黑 土
爇	艹 土 八 灬
爈	火 {虎头} 田 心
爉	火 巛 囗 {鼠下}
爊	火 鹿 灬
爋	火 千 黑 力
爌	火 广 龷 八
爍	火 白 幺 木
爎	火 宀 大 小
爏	火 厂 禾 止
爐	火 {虎头} 田 皿
爑	火 艹 隹 灬
爒	月 火 大 小
爓	火 門 冖 臼
爔	火 羊 禾 戈
爕	言 火 火 火
爖	火 立 月 {龍右}
爗	火 日 艹 龷
爘	火 卜 夕 食
爙	火 {京頭} 口 𧘇
爚	火 合 口 冊
爛	火 門 木 丷
爜	火 业 䒑 又
爞	火 虫 虫 虫
爟	火 艹 口 隹
爠	火 目 目 隹
爡	火 艹 禺 虫
爢	麻 非 灬
爣	火 尚 黑
爤	火 艹 門 丷
爥	火 尸 水 虫
爦	火 臣 {⺮右} 見
爧	火 雨 口 人
爩	火 木 缶 彡
爫	爪
爭	爪 彐 亅
爮	爪 勹 巳
爯	爪 冂 土
爲	爪 {爲下}
爳	爪 {爲下} 了
爴	囗 戈 口 爪
爺	八 乂 耳 阝
爼	乂 乂 且
爾	一 八 巾 乂
牀	爿 木
牁	爿 丁 口
牂	爿 羊
牃	爿 世 木
牄	爿 人 丶 口
牅	爿 广 肀 月
牆	爿 土 人 口
牉	片 丷 キ
牊	片 刀 口
牋	片 戈 戈
牎	片 勹 {两撇} 心
牏	片 人 一 刂
牐	片 千 臼
牑	片 户 冊
牓	片 亠 丷 方
牔	片 甫 寸
牕	片 {囟框} 夊 心
牗	片 广 肀 月
牘	片 士 罒 貝
牚	尚 牙
牜	牛
牞	牛 力
牠	牛 也
牣	牛 刀 丶
牤	牛 亡
牥	牛 方
牨	牛 亠 几
牪	牛 牛
牫	牛 戈
牬	牛 丿 ㇉ 丿
牭	牛 囗 儿
牰	牛 由
牱	牛 丁 口
牳	牛 母
牴	牛 {卬左} 七 丶
牶	丷 夫 牛
牷	牛 人 王
牸	牛 宀 子
牻	牛 尤 彡
牼	牛 一 巛 工
牽	亠 幺 冖 牛
犂	禾 勹 丿 牛
犃	牛 立 口
犅	牛 冂 䒑 山
犆	牛 十 且
犇	牛 牛 牛
犈	牛 丷 夫 㔾
犉	牛 {京頭} 子
犌	牛 尸 二 又
犎	土 土 寸 牛
犐	牛 禾 ⺀ 十
犑	牛 目 犬
犓	牛 勹 屮 屮
犔	牛 气 米
犕	牛 龷 丿 用
犖	火 火 冖 牛
犗	牛 宀 丰 口
犘	麻 牛
犙	牛 厶 厶 彡
犚	尸 示 寸 牛
犛	未 夊 厂 牛
犜	牛 {京頭} 子 夊
犝	牛 立 里
犞	牛 夭 口 口
犠	牛 羊 丿 戈
犡	牛 厂 艹 禺
犢	牛 士 罒 貝
犣	牛 巛 囗 {鼠下}
犤	牛 罒 厶 匕
犥	牛 鹿 灬
犦	牛 日 龷 水
犧	牛 羊 禾 戈
犨	隹 隹 牛
犩	禾 女 鬼 牛
犪	牛 䒑 自 夊
犫	隹 言 隹 牛
犮	{左上} 又 丶
犱	犭 九 丶
犲	犭 {于下} 丿
犳	犭 勹 丶
犵	犭 𠂉 乙
犺	犭 亠 几
犻	犭 一 巾
犼	犭 子 乚
犽	犭 牙
犾	犭 犬
犿	犭 亠 卜
狀	爿 犬
狅	犭 壬
狆	犭 口 丨
狇	犭 木
狉	犭 不 一
狊	目 犬
狋	犭 示
狌	犭 生
狏	犭 𠂉 也
狑	犭 人 丶 マ
狓	犭 皮
狔	犭 尸 匕
狕	犭 幺 力
狖	犭 穴
狘	犭 戈 乚
狚	犭 日 一
狛	犭 白
狜	犭 古
狝	犭 冖 小
狟	犭 一 日 一
狢	犭 夊 口
狣	犭 儿 二 二
狤	犭 士 口
狥	犭 勹 日
狦	犭 冊 一
狧	犭 舌
狪	犭 冂 一 口
狫	犭 耂 匕
狵	犭 尤 彡
狶	犭 乂 {左上} 巾
狹	犭 大 人 人
狽	犭 貝
狾	犭 扌 斤
狿	犭 丿 止 廴
猀	犭 氵 小 丿
猂	犭 日 干
猄	犭 {京頭} 小
猅	犭 非
猆	非 犬
猇	犭 虎
猈	犭 {卑上} 十
猉	犭 其
猋	犬 犬 犬
猌	來 犬
猍	犭 來
猏	犭 户 月
猐	犭 羊 乚
猑	犭 日 匕 匕
猒	日 月 犬
猔	犭 宀 示
猘	犭 牛 冂 刂
猙	犭 爪 彐 亅
猚	犭 隹
猟	犭 ⺍ 几 キ
猠	犭 冂 龷 八
猣	犭 乂 凵 夊
猤	犭 癶 一 大
猦	犭 風
猧	犭 咼
猨	犭 爪 干 又
猭	犭 {互中} 豕
猯	犭 山 而
猰	犭 丰 刀 大
猲	犭 日 勹 乚
猳	犭 尸 二 又
猵	犭 户 冊
猶	犭 丷 酉
猺	犭 爪 缶
猻	犭 子 丿 糸
猼	犭 甫 寸
猽	犭 冖 日 八
獀	犭 臼 丨 又
獁	犭 馬
獂	犭 厂 白 小
獃	山 一 口 犬
獄	犭 言 犬
獅	犭 𠂤 一 巾
獆	犭 白 大 十
獇	犭 羊 乚 厶
獈	犭 䒑 八 皿
獉	犭 𡗗 禾
獊	犭 人 丶 口
獋	犭 自 二 十
獌	犭 日 罒 又
獎	爿 月 寸 犬
獏	犭 艹 日 大
獑	犭 車 斤
獓	犭 龶 勹 夊
獔	犭 白 二 十
獕	犭 山 隹
獖	犭 十 卄 貝
獘	丷 巾 八 犬
獙	犭 丷 巾 夊
獚	犭 龷 由 八
獛	犭 业 䒑 夫
獜	犭 米 夕 ヰ
獝	犭 予 丿 口
獞	犭 立 里
獟	犭 土 土 兀
獡	犭 臼 勹 灬
獢	犭 夭 口 口
獣	⺍ 田 一 犬
獤	犭 {京頭} 子 夊
獥	犭 白 方 夊
獦	犭 艹 日 乚
獧	犭 罒 一 𧘇
獨	犭 罒 勹 虫
獩	犭 止 戊 小
獪	犭 人 一 日
獫	犭 僉
獮	犭 一 八 乂
獰	犭 宀 心 丁
獱	犭 宀 一 貝
獲	犭 艹 隹 又
獳	犭 雨 而
獴	犭 艹 冖 豕
獵	犭 巛 囗 {鼠下}
獶	犭 丆 月 夊
獷	犭 广 龷 八
獸	口 口 田 犬
獹	犭 {虎头} 田 皿
獺	犭 木 口 貝
獻	{虎头} 一 口 犬
獼	犭 弓 一 乂
獽	犭 {京頭} 口 𧘇
獿	犭 丆 目 夊
玀	犭 罒 糹 隹
玁	犭 口 口 夊
玂	犭 艹 口 斤
玃	犭 目 目 又
玅	亠 幺 小 丿
玆	亠 幺 亠 幺
玈	亠 幺 𠂉 𧘇
玊	王 丶
玌	王 乚
玍	𠂉 土
玏	王 力
玐	王 八
玒	王 工
玓	王 勹 丶
玔	王 川
玕	王 干
玗	王 一 {于下}
玘	王 己
玙	王 丂 一
玚	王 𠄎 {两撇}
玜	王 八 厶
玝	王 𠂉 十
玞	王 夫
玠	王 人 {介下}
玡	王 牙
玣	王 亠 卜
玤	王 丰
玥	王 月
玦	王 コ 人
玧	王 厶 儿
玨	王 王
玪	王 人 丶 乛
玬	王 ⺆ 亠
玭	王 匕 匕
玱	王 人 㔾
玴	王 世
玵	王 卄 二
玶	王 干 丷
玸	王 勹 巳
玹	王 亠 幺
玼	王 止 匕
玽	王 勹 口
玾	王 甲
玿	王 刀 口
珁	王 瓦
珃	王 冂 土
珄	王 生
珅	王 申
珆	王 厶 口
珇	王 且
珋	王 卯
珌	王 心 丿
珎	王 冖 小
珒	王 彐 キ
珓	王 亠 八 乂
珔	王 {左上} 丨 子
珕	王 力 力 力
珖	王 小 兀
珗	王 ⺧ 儿
珘	王 舟
珚	王 囗 大
珛	王 {左上} 月
珜	王 羊
珝	王 习 习
珟	王 几 一 夕
珡	王 王 人
珢	王 艮
珣	王 勹 日
珤	王 缶
珦	王 向
珨	王 合
珪	王 土 土
珫	王 亠 厶 儿
珬	王 戊 一
珮	王 几 一 巾
珯	王 耂 匕
珰	王 小 彐
珱	王 ⺍ 女
珳	王 文 彡
珴	王 丿 扌 戈
珵	王 口 王
珶	王 丷 弓 丿
珷	王 一 弋 止
珸	王 一 {五下} 口
珹	王 戊 乛
珺	王 彐 丿 口
珻	王 𠂉 母
珼	王 貝
珽	王 壬 廴
現	王 見
珿	王 足
琀	王 人 丶 口
琁	王 𠂉 乛 龰
琂	王 言
琄	王 口 月
琇	王 禾 乃
琈	王 爪 子
琋	王 乂 {左上} 巾
琌	王 山 人 乛
琍	王 禾 刂
琎	王 二 {介下} 辶
琑	王 小 月
琒	王 夊 丰
琓	王 宀 一 兀
琔	王 宀 一 龰
琕	王 {卑上} 十
琖	王 戈 戈
琗	王 亠 人 十
琘	王 {卬左} 七 日
琙	王 戈 口 一
琜	王 來
琝	王 日 文
琞	日 月 王 丶
琟	王 隹
琠	王 冂 龷 八
琡	王 上 小 又
琣	王 立 口
琤	王 冖 彐 亅
琧	一 {亞下} 王 丶
琩	王 日 日
琫	王 𡗗 キ
琭	王 彐 水
琯	王 宀 尸 コ
琱	王 ⺆ 土 口
琲	王 非
琷	王 羊 乚
琸	王 卜 早
琹	王 王 木
琺	王 氵 土 厶
琻	王 金
琽	王 耂 日
琾	王 田 人 {介下}
琿	王 冖 車
瑀	王 丿 虫 冂
瑂	王 {眉上} 目
瑃	王 𡗗 日
瑄	王 宀 一 一
瑅	王 日 一 龰
瑆	王 日 生
瑇	王 龶 母
瑈	王 予 丿 木
瑉	王 巳 七 日
瑊	王 戊 一 口
瑋	王 韋
瑌	王 而 大
瑍	王 冖 冂 大
瑎	王 匕 匕 白
瑏	王 穴 牙
瑐	王 䒑 月 刂
瑑	王 {互中} 豕
瑒	王 日 一 {两撇}
瑓	王 木 囗 丷
瑔	王 白 水
瑖	王 亻 三 殳
瑘	王 耳 阝
瑝	王 白 王
瑠	王 卯 田
瑡	王 𠂤 一 巾
瑢	王 穴 人 口
瑣	王 小 貝
瑤	王 月 缶
瑥	王 日 皿
瑦	王 烏
瑧	王 𡗗 禾
瑨	王 丌 䒑 日
瑩	火 火 冖 丶
瑪	王 馬
瑫	王 爪 臼
瑬	氵 亠 厶 丶
瑮	王 西 木
瑯	王 丶 彐 阝
瑱	王 十 且 八
瑲	王 人 丶 口
瑳	王 羊 工
瑴	{穀頭} 一 王
瑵	王 又 丶 虫
瑸	王 宀 斤 八
瑹	王 艹 人 木
瑺	王 尚 巾
瑻	王 {母框} 十 貝
瑼	王 {專上} 寸
瑽	王 彳 人 龰
瑿	匚 矢 殳 丶
璂	王 其 土
璄	王 立 日 儿
璅	王 巛 日 木
璆	王 习 习 彡
璈	王 龶 勹 夊
璉	王 車 辶
璊	王 卄 一 入
璌	王 宀 一 八
璍	王 艹 干 龷
璏	王 彑 匕 匕
璑	王 𠂉 卌 灬
璒	王 癶 一 䒑
璓	王 艹 禾 乃
璔	王 丷 日 日
璕	王 彐 工 寸
璖	王 氵 匚 木
璗	氵 日 一 丶
璘	王 米 夕 ヰ
璙	王 大 丷 小
璚	王 予 丿 口
璛	王 肀 片 一
璝	王 口 丄 貝
璟	王 日 {京頭} 小
璠	王 丿 米 田
璡	王 隹 辶
璢	王 丌 匚 田
璣	王 幺 幺 人
璤	王 {專上} 心
璥	王 艹 勹 夊
璦	王 爪 冖 夊
璪	王 口 口 木
璫	王 尚 田
璬	王 白 方 夊
璭	王 冖 車 辶
璮	王 亠 囗 一
璯	王 人 一 日
環	王 罒 一 𧘇
璱	王 王 王 丿
璲	王 䒑 豕 辶
璳	王 牛 八 貝
璴	王 木 木 龰
璵	王 臼 丂 八
璶	王 肀 一 皿
璷	王 甫 方 夊
璸	王 宀 一 貝
璹	王 士 乛 寸
璻	王 习 习 十
璼	王 臣 {⺮右} 皿
璽	一 八 巾 丶
璾	王 亠 丷 二
璿	王 卜 冖 目
瓀	王 雨 而
瓁	王 艹 隹 又
瓂	王 艹 土 皿
瓃	王 田 田 田
瓄	王 士 罒 貝
瓅	王 白 幺 木
瓆	王 斤 斤 貝
瓇	王 丆 月 夊
瓈	王 禾 勹 水
瓉	王 夫 夫 貝
瓊	王 冖 冂 夊
瓋	王 亠 丷 辶
瓌	王 亠 罒 𧘇
瓍	王 阝 {左上} 辶
瓎	王 木 口 貝
瓏	王 立 月 {龍右}
瓐	王 {虎头} 田 皿
瓑	王 厂 禾 止
瓓	王 門 木 丷
瓔	王 貝 貝 女
瓕	弓 一 八 丶
瓖	王 {京頭} 口 𧘇
瓗	王 山 隹 口
瓘	王 艹 口 隹
瓙	王 士 乛 灬
瓚	王 ⺧ 儿 貝
瓛	王 {虎头} 一 犬
瓝	瓜 勹 丶
瓟	瓜 勹 巳
瓡	土 䒑 十 瓜
瓥	瓜 豕 虫 虫
瓧	瓦 十
瓨	工 瓦
瓩	瓦 千
瓪	瓦 ⺁ 又
瓫	八 刀 瓦
瓬	方 瓦
瓭	冖 儿 瓦
瓰	瓦 八 刀
瓱	瓦 毛
瓲	瓦 七 凵
瓳	古 瓦
瓵	厶 口 瓦
瓸	瓦 丆 日
瓹	口 月 瓦
瓺	镸 瓦
瓻	乂 {左上} 巾 瓦
瓼	瓦 里
瓽	尚 瓦
瓾	禾 女 瓦
甀	壬 龷 瓦
甁	丿 干 丿 瓦
甂	户 冊 瓦
甃	禾 火 瓦
甅	瓦 厂 里
甆	䒑 幺 幺 瓦
甇	火 火 冖 瓦
甈	自 木 瓦
甉	䒑 彐 〢 瓦
甊	口 十 口 瓦
甋	亠 丷 冂 瓦
甌	匚 口 口 瓦
甎	{專上} 寸 瓦
甐	米 夕 ヰ 瓦
甒	𠂉 卌 一 瓦
甔	冖 厂 八 瓦
甕	亠 {纟上} 丿 瓦
甖	貝 貝 瓦
甗	{虎头} 一 口 瓦
甛	卄 二 舌
甝	虎 卄 二
甞	尚 卄 二
甠	日 生
甡	生 生
產	文 厂 生
産	立 丿 生
甤	豕 生
甦	一 日 乂 生
甧	生 生 月
甪	丿 用
甮	勹 {两撇} 用
甴	日 丨
甶	丿 田
甹	由 丂
甼	田 丁
甽	田 川
甿	田 亡
畁	由 丌
畂	田 冖 丶
畃	申 勹 丶
畄	⺍ 田
畆	亠 田 厶
畇	田 勹 二
畉	田 夫
畊	田 二 {介下}
畍	田 人 {介下}
畐	一 口 田
畑	火 田
畒	亠 田 人
畓	水 田
畕	田 田
畖	田 瓜
畗	{京頭} 田
畘	田 冂 土
畝	亠 田 冖 丶
畞	十 田 冖 丶
畟	田 八 夊
畠	白 田
畡	田 亥
畢	日 卄 キ
畣	合 田
畤	田 土 寸
畧	田 夊 口
畨	米 田
畩	田 亠 𧘇
畫	彐 土 田 一
畬	人 一 木 田
畭	田 人 一 木
畮	田 𠂉 母
畯	田 厶 八 夊
異	田 龷 八
畱	丌 匚 コ 田
畳	田 冖 且
畵	彐 土 田 凵
當	尚 田
畷	田 又 又 又
畺	一 田 一 一
畻	田 丷 夫 土
畼	田 日 一 {两撇}
畽	田 千 里
畾	田 田 田
疀	巛 田 一 龰
疁	田 习 习 彡
疂	田 二 二 且
疄	田 米 夕 ヰ
疅	田 一 田 一
疇	田 士 乛 寸
疈	一 口 田 田
疉	田 田 田 彑
疊	田 田 田 且
疌	一 彐 龰
疍	乛 龰 日 一
疎	乛 止 木 口
疐	十 冖 田 龰
疓	疒 乃
疕	疒 匕
疘	疒 工
疛	疒 寸
疜	疒 下
疞	疒 一 丂
疢	疒 火
疦	疒 コ 人
疧	疒 {卬左} 七
疨	疒 牙
疩	疒 九 十
疪	疒 匕 匕
疭	疒 人 人
疶	疒 世
疷	疒 {卬左} 七 丶
疺	疒 丿 之
疻	疒 口 八
疿	疒 弓 {介下}
痀	疒 勹 口
痁	疒 卜 口
痆	疒 尸 匕
痋	疒 虫
痌	疒 冂 一 口
痎	疒 亥
痏	疒 {左上} 月
痐	疒 囗 口
痑	疒 夕 夕
痓	疒 至
痗	疒 𠂉 母
痙	疒 一 巛 工
痚	疒 耂 子
痜	疒 禾 几
痝	疒 尤 彡
痟	疒 小 月
痠	疒 厶 八 夊
痡	疒 甫
痥	疒 丷 口 儿
痩	疒 申 又
痬	疒 日 勹 {两撇}
痭	疒 月 月
痮	疒 長
痯	疒 宀 尸 コ
痲	麻 二
痳	麻 二
痵	疒 禾 子
痶	疒 冂 龷 八
痷	疒 大 电
痸	疒 牛 冂 刂
痺	疒 {卑上} 十
痻	疒 {卬左} 七 日
痽	疒 隹
痾	疒 阝 丁 口
瘂	疒 一 {亞下}
瘄	疒 龷 日
瘆	疒 厶 大 彡
瘇	疒 千 里
瘈	疒 丰 刀 大
瘉	疒 人 一 刂
瘋	疒 風
瘍	疒 日 一 {两撇}
瘎	疒 其 乚
瘏	疒 耂 日
瘑	疒 咼
瘒	疒 冖 車
瘓	疒 冖 冂 大
瘔	疒 艹 古
瘖	疒 立 日
瘚	疒 䒑 屮 欠
瘜	疒 自 心
瘝	疒 罒 水
瘞	疒 大 人 土
瘡	疒 人 丶 口
瘣	疒 鬼
瘧	疒 {虎头} {反彐}
瘨	疒 十 且 八
瘬	疒 弓 長
瘮	疒 厶 厶 彡
瘯	疒 方 𠂉 矢
瘱	疒 大 人 心
瘲	疒 彳 人 龰
瘶	疒 木 口 欠
瘷	疒 木 口 夊
瘹	疒 金 勹 丶
瘺	疒 尸 雨
瘻	疒 口 十 女
瘽	疒 革 二
癁	疒 彳 𠂉 夊
療	疒 大 丷 小
癄	疒 隹 灬
癅	疒 丌 匚 田
癆	疒 火 火 力
癇	疒 門 月
癈	疒 癶 弓 殳
癉	疒 口 口 十
癊	疒 阝 人 厶
癋	疒 一 {亞下} 心
癎	疒 門 日
癏	疒 罒 一 𧘇
癐	疒 人 一 日
癑	疒 冂 龷 辰
癒	疒 人 一 心
癓	疒 {微上} 一 几
癕	疒 亠 {纟上} 隹
癗	疒 雨 田
癘	疒 艹 禺
癙	疒 臼 {鼠下}
癚	疒 冖 厂 言
癛	疒 亠 囗 禾
癝	疒 亠 囗 示
癟	疒 自 人 冊
癠	疒 亠 丷 二
癡	疒 匕 矢 龰
癢	疒 䒑 夫 艮
癤	疒 竹 彐 卩
癥	疒 {微上} 一 王
癦	疒 黑 土
癧	疒 厂 禾 止
癨	疒 雨 隹
癩	疒 木 口 貝
癪	疒 禾 龶 貝
癬	疒 魚 羊
癭	疒 貝 貝 女
癮	疒 阝 爪 心
癰	疒 巛 口 隹
癱	疒 卄 一 隹
癲	疒 十 且 貝
癳	疒 田 田 糸
癴	疒 言 糹 手
癵	疒 言 糹 人
癶	癶
癷	癶 干
癹	癶 殳
発	癶 二 儿
發	癶 弓 殳
癿	白 乚
皀	白 匕
皁	白 十
皃	白 儿
皅	白 巴
皉	白 止 匕
皊	白 人 丶 マ
皌	白 末
皍	白 匕 卩
皏	白 䒑 卄
皐	白 二 二 十
皒	白 丿 扌 戈
皔	白 日 干
皕	丆 日 丆 日
皗	白 ⺆ 土 口
皘	白 龶 月
皚	白 山 一 䒑
皛	白 白 白
皜	白 高
皝	白 王 小 兀
皞	白 白 大 十
皟	白 龶 貝
皠	白 山 隹
皡	白 白 二 十
皢	白 土 土 兀
皣	白 艹 干 龷
皥	白 自 二 十
皦	白 白 方 夊
皧	白 爪 冖 夊
皨	白 白 白 土
皩	白 王 日 兀
皪	白 白 幺 木
皫	白 鹿 灬
皬	白 雨 隹
皭	白 爪 罒 寸
皯	皮 干
皰	皮 勹 巳
皳	一 水 丶 皮
皵	龷 日 皮
皶	木 日 一 皮
皷	士 口 䒑 皮
皸	冖 車 皮
皹	皮 冖 車
皺	勹 屮 勹 皮
皻	{虎头} 且 皮
皼	士 冖 一 皮
皽	亠 囗 口 皮
皾	士 罒 貝 皮
盀	卜 皿
盁	乃 皿
盃	不 皿
盄	弓 丨 皿
盇	大 丶 皿
盉	禾 皿
盋	{左上} 又 丶 皿
盌	夕 㔾 皿
盓	氵 一 {于下} 皿
盕	氵 几 丶 皿
盙	甫 皿
盚	一 水 丶 皿
盜	氵 欠 皿
盝	彐 水 皿
盞	戈 戈 皿
盠	{互中} 豕 皿
盡	肀 一 灬 皿
盢	田 犬 皿
監	臣 {⺮右} 皿
盤	舟 殳 皿
盦	人 丶 乛 皿
盧	{虎头} 田 皿
盨	彡 丆 貝 皿
盩	土 䒑 十 皿
盪	氵 日 一 皿
盫	合 酉 皿
盬	臣 𠂉 古 皿
盭	幺 土 䒑 皿
盰	目 干
盳	目 亡
盵	目 𠂉 乙
盶	目 一 兀
盷	目 勹 二
盺	目 斤
盻	目 八 丂
盽	目 丰
盿	目 文
眀	目 月
眂	目 {卬左} 七
眃	目 二 厶
眅	目 ⺁ 又
眆	目 方
眊	目 毛
県	目 乚 小
眎	目 示
眏	目 冂 大
眐	目 一 止
眑	目 幺 力
眒	目 申
眓	目 戈 乚
眔	罒 水
眕	目 人 彡
眖	目 口 儿
眗	目 勹 口
眘	大 丷 目
眛	目 未
眜	目 末
眝	目 宀 丁
眞	匕 目 乚 八
眡	目 {卬左} 七 丶
眣	目 丿 夫
眤	目 尸 匕
眥	止 匕 目
眧	目 刀 口
眪	目 一 冂 人
眫	目 丷 キ
眬	目 尤 丿
眮	目 冂 一 口
眰	目 至
眱	目 大 弓
眲	目 耳
眳	目 夕 口
眴	目 勹 日
眹	目 䒑 大
眻	目 羊
眽	目 ⺁ 𧘇
眾	罒 亻 人 人
眿	目 丶 水
睂	人 人 丨 目
睄	目 小 月
睅	目 日 干
睆	目 宀 一 兀
睈	目 口 王
睉	目 人 人 土
睊	目 口 月
睋	目 丿 扌 戈
睌	目 冖 口 儿
睍	目 見
睎	目 乂 {左上} 巾
睏	目 囗 木
睒	目 火 火
睓	目 冂 龷 八
睔	目 人 一 冊
睕	目 宀 夕 㔾
睖	目 土 八 夊
睗	目 日 勹 {两撇}
睘	罒 一 口 𧘇
睙	目 户 犬
睜	目 爪 彐 亅
睝	禾 勹 丿 目
睞	目 來
睟	目 亠 人 十
睠	目 丷 夫 㔾
睤	目 田 丌
睧	目 {卬左} 七 日
睩	目 彐 水
睪	罒 土 䒑 十
睭	目 ⺆ 土 口
睮	目 人 一 刂
睯	巳 七 夊 目
睰	目 艹 {左上} 口
睱	目 尸 二 又
睲	目 日 生
睳	目 大 土 土
睴	目 冖 車
睵	目 十 戈 口
睶	目 𡗗 日
睷	目 彐 キ 廴
睸	目 {眉上} 目
睺	目 亻 コ 矢
睻	目 宀 一 一
睼	目 日 一 龰
瞁	目 目 犬
瞂	⺁ 十 目 丶
瞃	目 ⺁ 十 目
瞆	目 口 丄 贝
瞇	目 米 辶
瞈	目 八 厶 习
瞉	{穀頭} 一 目
瞊	目 广 肀 口
瞋	目 十 且 八
瞏	罒 土 口 𧘇
瞐	目 目 目
瞓	目 言 川
瞔	目 龶 貝
瞕	目 立 早
瞖	匚 矢 殳 目
瞗	目 鳥
瞘	目 匚 口 口
瞙	目 艹 日 大
瞚	目 宀 一 八
瞛	目 彳 人 龰
瞜	目 口 十 女
瞝	目 文 凵 厶
瞞	目 卄 一 入
瞡	目 夫 見
瞣	目 口 口 心
瞤	目 門 王
瞦	目 士 口 口
瞨	目 业 䒑 夫
瞫	目 西 早
瞭	目 大 丷 小
瞮	目 亠 厶 夊
瞯	目 門 月
瞱	目 艹 干 龷
瞲	目 予 丿 口
瞴	目 𠂉 卌 灬
瞶	目 口 丄 貝
瞷	目 門 日
瞸	目 艹 世 木
瞹	目 爪 冖 夊
瞺	目 人 一 日
瞼	目 僉
瞾	目 目 穴 工
矀	目 {微上} 一 几
矁	目 禾 火 心
矂	目 口 口 木
矃	目 宀 心 丁
矄	目 千 黑
矅	目 习 习 隹
矆	目 艹 隹 又
矇	目 艹 冖 豕
矈	目 白 穴 方
矉	目 宀 一 貝
矊	目 糹 白 巾
矋	目 厂 艹 禺
矌	目 广 龷 八
矎	目 冖 冂 夊
矏	目 自 穴 方
矐	目 雨 隹
矑	目 {虎头} 田 皿
矒	目 艹 罒 目
矓	目 立 月 {龍右}
矔	目 艹 口 隹
矕	言 糹 糹 目
矖	目 一 {冂丶} 鹿
矘	目 尚 黑
矙	目 門 乛 夊
矚	目 尸 水 虫
矝	予 丿 人 マ
矞	予 丿 冂 口
矟	予 丿 小 月
矠	予 丿 龷 日
矡	予 丿 目 又
矤	弓 矢
矦	冖 厂 矢
矨	矢 夭
矪	矢 舟
矯	矢 夭 口 口
矰	矢 丷 日 日
矱	矢 艹 隹 又
矲	矢 罒 厶 匕
矴	石 丁
矵	石 刂
矷	石 子
矹	石 兀
矺	石 丿 七
矻	石 𠂉 乙
矼	石 工
砃	石 ⺆ 亠
砄	石 コ 人
砅	石 水
砆	石 夫
砇	石 文
砈	石 厂 㔾
砊	石 亠 几
砋	石 止
砎	石 人 {介下}
砏	石 八 刀
砐	石 乃 乀
砓	石 殳
砕	石 九 十
砙	石 瓦
砛	石 人 丶 乛
砞	石 末
砠	石 且
砡	石 王 丶
砢	石 丁 口
砤	石 𠂉 也
砨	石 户 乙
砪	石 母
砫	石 丶 王
砮	女 又 石
砯	石 丶 水
砱	石 人 丶 マ
砲	石 勹 巳
砳	石 石
砵	石 木 一
砶	石 白
砽	石 用
砿	石 广 厶
硁	石 ス 工
硂	石 人 王
硃	石 牛 八
硄	石 小 兀
硆	石 合
硈	石 士 口
硉	石 彐 キ
硊	石 冖 厂 㔾
硋	石 亥
硍	石 艮
硏	石 干 干
硑	石 䒑 卄
硓	石 耂 匕
硔	石 龷 八
硘	石 囗 口
硙	石 山 己
硚	石 夭 {介下}
硛	石 亦
硜	石 一 巛 工
硞	石 ⺧ 口
硟	石 丿 止 廴
硠	石 丶 艮
硡	石 宀 {左上} 厶
硢	石 人 一 木
硣	石 耂 子
硤	石 大 人 人
硥	石 尤 彡
硦	石 王 卄
硧	石 マ 用
硨	石 車
硩	扌 斤 石
硯	石 見
硰	氵 小 丿 石
硱	石 囗 木
硲	石 八 人 口
硳	石 土 {介下} 八
硴	石 艹 亻 匕
硵	石 卜 囗 乂
硶	石 山 人 乛
硸	石 山 厂 干
硹	石 木 八 厶
硺	石 豕 丶
硻	臣 又 石
硽	石 大 电
硾	石 壬 龷
硿	石 穴 工
碀	石 冖 彐 亅
碁	其 石
碂	石 宀 示
碃	石 龶 月
碄	石 木 木
碅	石 囗 禾
碆	氵 皮 石
碈	石 {卬左} 七 日
碊	石 戈 戈
碋	石 山 丁 口
碏	石 龷 日
碐	石 土 八 夊
碒	石 金
碔	石 一 弋 止
碕	石 大 丁 口
碖	石 人 一 冊
碙	石 冂 䒑 山
碝	石 而 大
碞	口 口 口 石
碠	石 {亮頭} 丁
碢	石 咼
碤	石 艹 冂 大
碦	石 宀 夊 口
碨	石 田 {畏下}
碩	石 丆 貝
碪	石 其 乚
碫	石 亻 三 殳
碬	石 尸 二 又
碭	石 日 一 {两撇}
碮	石 日 一 龰
碯	石 巛 {囟框} 乂
碵	石 卜 貝
碶	石 丰 刀 大
碷	石 ⺁ 十 目
碸	石 風
確	石 冖 隹
碻	石 高
碼	石 馬
碽	石 工 貝
碿	石 尸 小 月
磀	石 䒑 屮 辶
磂	石 卯 田
磃	石 ⺁ 虎
磄	石 广 肀 口
磆	石 骨
磇	石 {囟框} 乂 匕
磈	石 鬼
磌	石 十 且 八
磍	石 宀 丰 口
磎	石 爪 幺 大
磏	石 䒑 彐 八
磑	石 山 一 䒑
磒	石 口 貝
磓	石 𠂤 辶
磖	石 习 习 白
磗	石 甫 寸
磘	石 爪 缶
磚	石 {專上} 寸
磛	車 斤 石
磜	石 {祭上} 示
磝	石 龶 勹 夊
磞	石 山 月 月
磟	石 习 习 彡
磠	石 鹵
磡	石 其 乚 力
磢	石 大 乂 乂
磣	石 厶 厶 彡
磤	石 ⺁ 彐 殳
磥	石 田 糸
磦	石 西 示
磧	石 龶 貝
磩	石 戊 上 小
磪	石 山 隹
磫	石 彳 人 龰
磭	石 辰 月
磮	石 山 人 冊
磯	石 幺 幺 人
磰	石 羊 䒑 口
磱	石 火 火 力
磳	石 丷 日 日
磵	石 門 日
磶	石 臼 勹 灬
磸	石 丷 酉 大
磹	石 西 早
磻	石 丿 米 田
磼	石 隹 木
磽	石 土 土 兀
磾	石 口 口 十
磿	厂 禾 禾 石
礀	石 門 月
礂	石 士 口 口
礃	石 尚 手
礄	石 夭 口 口
礆	石 僉
礇	石 {向框} 米 大
礈	石 䒑 豕 辶
礉	石 白 方 夊
礊	車 凵 殳 石
礋	石 罒 土 十
礌	石 雨 田
礍	石 艹 日 乚
礎	石 木 木 龰
礏	石 业 羊 八
礐	臼 乂 乂 石
礑	石 尚 田
礒	石 羊 丿 戈
礔	石 尸 口 辛
礕	尸 口 辛 石
礖	石 臼 丂 八
礗	石 宀 一 貝
礘	石 日 幺 灬
礙	石 匕 矢 龰
礚	石 艹 土 皿
礛	石 臣 {⺮右} 皿
礜	臼 丂 丄 石
礝	石 雨 而
礟	石 馬 乂 乂
礠	石 䒑 幺 心
礡	石 艹 甫 寸
礢	石 䒑 夫 艮
礣	石 艹 罒 丶
礥	石 臣 又 貝
礦	石 广 龷 八
礧	石 田 田 田
礨	田 田 田 石
礩	石 斤 斤 貝
礪	石 厂 艹 禺
礫	石 白 幺 木
礬	木 乂 乂 石
礭	石 雨 隹
礮	石 馬 亠 乂
礯	石 火 火 糸
礰	石 厂 禾 止
礱	立 月 {龍右} 石
礲	石 立 月 {龍右}
礳	石 麻 石
礵	石 雨 木 目
礶	石 艹 口 隹
礷	石 艹 臣 皿
礸	石 ⺧ 儿 貝
礹	石 口 口 夊
礽	示 乃
礿	示 勹 丶
祂	示 也
祃	示 马
祄	示 人 {介下}
祅	示 夭
祇	示 {卬左} 七
祊	示 方
祋	示 殳
祌	示 口 丨
祍	示 壬
祎	示 キ 乛
祏	示 石
祐	示 {左上} 口
祑	示 丿 夫
祒	示 刀 口
祔	示 亻 寸
祕	示 心 丿
祘	示 示
祙	示 未
祡	止 匕 示
祣	示 𠂉 𧘇
祤	示 习 习
祦	示 口 一 大
祩	示 牛 八
祪	示 冖 厂 㔾
祫	示 合
祬	示 至
祮	示 士 口
祰	示 ⺧ 口
祱	示 丷 口 儿
祲	示 彐 冖 又
祳	示 辰
祴	示 戈 卄
祵	示 囗 木
祶	示 丷 弓 丿
祹	示 勹 缶
祻	示 囗 古
祼	示 日 木
祽	示 亠 人 十
祾	示 土 八 夊
祿	示 彑 水
禂	示 ⺆ 土 口
禃	示 十 且
禆	示 {卑上} 十
禇	示 耂 日
禈	示 冖 車
禉	示 丷 酉
禋	示 西 土
禌	示 䒑 幺 幺
禍	示 咼
禎	示 卜 貝
禐	示 爪 干 又
禑	示 禺
禒	示 {互中} 豕
禓	示 日 一 {两撇}
禔	示 日 一 龰
禕	示 韋
禖	示 卄 二 木
禗	示 田 心
禘	示 亠 丷 巾
禙	示 丬 匕 月
禛	示 十 且 八
禜	火 火 冖 示
禝	示 田 八 夊
禞	示 高
禟	示 广 肀 口
禠	示 ⺁ 虎
禡	示 馬
禢	示 日 习 习
禣	示 甫 寸
禤	示 罒 习 习
禥	示 其 土
禦	彳 𠂉 一 示
禨	示 幺 幺 人
禩	示 田 龷 八
禪	示 口 口 十
禫	示 西 早
禬	示 人 一 日
禭	示 䒑 豕 辶
禮	示 冂 龷 䒑
禯	示 冂 龷 辰
禰	示 一 八 乂
禱	示 士 乛 寸
禲	示 厂 艹 禺
禴	示 合 口 冊
禵	示 日 一 貝
禶	示 ⺧ 儿 貝
禷	示 米 犬 貝
禸	冂 厶
禼	卜 囗 乂 厶
禿	禾 儿
秂	禾 人
秄	禾 子
秅	禾 丿 七
秇	禾 九 丶
秈	禾 山
秊	禾 千
秌	火 禾
秎	禾 八 刀
秏	禾 毛
秐	禾 二 厶
秓	禾 十 又
秔	禾 亠 几
秖	禾 {卬左} 七
秗	禾 夭
秙	禾 古
秚	禾 丷 キ
秛	禾 皮
秜	禾 尸 匕
秝	禾 禾
秞	禾 由
秠	禾 不 一
秡	禾 {左上} 又 丶
秢	禾 人 丶 マ
秥	禾 卜 口
秨	禾 𠂉 {乍下}
秪	禾 {卬左} 七 丶
秬	禾 匚 コ
秮	禾 厶 口
秱	禾 冂 一 口
秲	禾 土 寸
秳	禾 舌
秴	禾 合
秵	禾 囗 大
秶	二 欠 禾
秷	禾 至
秹	禾 亻 壬
秺	禾 宀 丿 七
秼	禾 牛 八
秾	禾 冖 𧘇
秿	禾 甫
稁	{亮頭} 禾
稄	禾 厶 八 夊
稅	禾 八 口 儿
稇	禾 囗 木
稈	禾 日 干
稉	禾 一 日 乂
稊	禾 丷 弓 丿
稌	禾 人 一 木
稏	禾 一 {亞下}
稐	禾 人 一 冊
稑	禾 土 八 土
稒	禾 囗 古
稓	禾 龷 日
稕	禾 {京頭} 子
稖	禾 立 口
稘	禾 其
稙	禾 十 且
稛	禾 囗 禾
稜	禾 土 八 夊
稝	禾 月 月
稟	亠 囗 口 禾
稡	禾 亠 人 十
稢	禾 戈 口 一
稤	禾 {京頭} 小
稥	禾 灬 日
稦	禾 韋
稧	禾 丰 刀 大
稨	禾 户 冊
稩	禾 田 月
稪	禾 𠂉 日 夊
稫	禾 一 口 田
稬	禾 而 大
稭	禾 匕 匕 白
種	禾 千 里
稯	禾 乂 凵 夊
稰	禾 乛 龰 月
稱	禾 爪 冂 土
稲	禾 爪 丨 日
稴	禾 䒑 彐 八
稵	禾 䒑 幺 幺
稶	禾 戈 口 {两撇}
稸	禾 亠 幺 田
稺	禾 尸 辛
稾	高 禾
穀	{穀頭} 一 禾
穁	禾 艹 耳
穂	禾 一 由 心
穃	禾 穴 人 口
穄	禾 {祭上} 示
穅	禾 广 彐 水
穇	禾 厶 厶 彡
穈	麻 禾
穉	禾 尸 水 牛
穊	禾 彐 厶 儿
穋	禾 习 习 彡
穌	魚 禾
積	禾 龶 貝
穎	匕 禾 丆 貝
穏	禾 爪 彐 心
穐	禾 冖 日 电
穒	禾 鳥
穓	禾 田 龷 八
穔	禾 龷 由 八
穕	禾 隹 木
穖	禾 幺 幺 人
穘	禾 土 土 兀
穙	禾 业 䒑 夫
穚	禾 夭 口 口
穛	禾 隹 灬
穜	禾 立 里
穝	禾 日 耳 又
穞	禾 鱼 日
穟	禾 䒑 豕 辶
穠	禾 冂 龷 辰
穡	禾 土 人 口
穢	禾 止 戊 小
穣	禾 亠 八 𧘇
穤	禾 雨 而
穥	禾 臼 丂 八
穦	禾 宀 一 貝
穧	禾 亠 丷 二
穨	禾 几 口 貝
穩	禾 爪 工 心
穪	禾 一 八 乂
穫	禾 艹 隹 又
穬	禾 广 龷 八
穭	禾 魚 日
穮	禾 鹿 灬
穯	禾 土 口 口
穱	禾 爪 罒 寸
穲	禾 一 {冂丶} 鹿
穳	禾 ⺧ 儿 貝
穵	穴 乙
穻	穴 一 {于下}
穼	穴 木
穽	穴 二 {介下}
穾	穴 夭
窂	穴 牛
窅	穴 目
窇	穴 勹 巳
窉	穴 一 冂 人
窊	穴 瓜
窋	穴 屮 凵
窌	穴 卯
窎	穴 鸟
窏	穴 氵 一 {于下}
窐	穴 土 土
窓	穴 厶 心
窔	穴 亠 八 乂
窙	穴 耂 子
窚	穴 戊 乛
窛	穴 一 兀 女
窞	穴 冖 臼
窡	穴 又 又 又
窢	穴 戈 口 一
窣	穴 亠 人 十
窤	穴 日 匕 匕
窧	穴 卜 早
窩	穴 咼
窪	穴 氵 土 土
窫	穴 丰 刀 大
窮	穴 身 弓
窯	穴 羊 灬
窰	穴 爪 缶
窱	穴 亻 丨 木
窲	穴 米 ⺀ 十
窴	穴 十 且 八
窵	穴 鳥
窶	穴 口 十 女
窷	穴 耳 卯
窸	穴 丿 米 心
窹	穴 爿 一 口
窺	穴 夫 見
窻	穴 {囟框} 夊 心
窼	穴 巛 日 木
窽	穴 匕 矢 欠
窾	穴 士 示 欠
竀	穴 一 止 見
竁	穴 毛 毛 毛
竂	穴 大 丷 小
竃	穴 土 日 电
竄	穴 臼 {鼠下}
竅	穴 白 方 夊
竆	穴 身 口 口
竇	穴 士 罒 貝
竈	穴 土 黽
竉	穴 立 月 {龍右}
竊	穴 丿 米 厶
竌	立 几
竍	立 十
竎	立 卄
竏	立 千
竐	立 殳
竑	立 {左上} 厶
竒	立 口 亅
竓	立 毛
竔	立 丿 卄
竕	立 八 刀
竗	立 小 丿
竘	立 勹 口
竚	立 宀 丁
竛	立 人 丶 マ
竜	立 电
竝	立 立
竡	立 丆 日
竢	立 厶 矢
竤	立 宀 {左上} 厶
竧	立 身
竨	立 卜 早
竩	立 宀 且
竪	臣 又 立
竫	立 冖 彐 亅
竬	立 丿 虫 冂
竮	立 尸 䒑 卄
竰	立 厂 里
竱	立 {專上} 寸
竲	立 丷 日 日
竳	立 癶 一 䒑
竴	立 丷 酉 寸
竵	立 一 口 丨
競	立 口 儿 儿
竷	立 早 夊 夊
竸	立 日 儿 儿
竻	竹 力
竼	竹 几 丶
竾	竹 也
笀	竹 亡
笁	竹 工
笂	竹 九 丶
笅	竹 乂 乂
笇	竹 亠 卜
笉	竹 勹 二
笌	竹 牙
笍	竹 冂 人
笎	竹 一 兀
笐	竹 亠 几
笒	竹 人 丶 乛
笓	竹 匕 匕
笖	竹 乚 丶 人
笗	竹 夊 ⺀
笘	竹 卜 口
笚	竹 甲
笜	竹 屮 凵
笝	竹 囗 又
笟	竹 瓜
笡	竹 且
笢	竹 巳 七
笣	竹 勹 巳
笧	竹 ⺆ ⺆ 一
笩	竹 亻 弋
笭	竹 人 丶 マ
笯	竹 女 又
笰	竹 弓 {介下}
笲	竹 厶 卄
笴	竹 丁 口
笵	竹 氵 㔾
笶	竹 矢
笷	竹 卯
笹	竹 世
笻	竹 工 卩
笽	竹 皿
笿	竹 夊 口
筀	竹 土 土
筁	竹 冂 龷
筂	竹 氵 也
筃	竹 囗 大
筄	竹 儿 二 二
筆	竹 彐 キ
筈	竹 舌
筊	竹 亠 八 乂
筍	竹 勹 日
筎	竹 女 口
筓	竹 干 干
筕	竹 彳 亍
筗	竹 亻 口 丨
筙	竹 丰 八
筜	竹 小 彐
筞	竹 宀 木
筟	竹 爪 子
筡	竹 人 一 木
筣	竹 禾 刂
筤	竹 丶 艮
筥	竹 口 口
筦	竹 宀 一 兀
筧	竹 見
筨	竹 人 丶 口
筩	竹 マ 用
筪	竹 匚 甲
筫	竹 貝
筬	竹 戊 乛
筭	竹 王 卄
筯	竹 且 力
筰	竹 亻 𠂉 {乍下}
筳	竹 壬 廴
筴	竹 大 人 人
筶	竹 ⺧ 口
筸	竹 日 干
筺	竹 匚 王 丶
筼	竹 口 贝
筽	竹 口 一 大
筿	竹 夊 木
箁	竹 立 口
箂	竹 來
箃	竹 耳 又
箄	竹 {卑上} 十
箆	竹 冂 人 匕
箇	竹 囗 古
箈	竹 氵 厶 口
箉	竹 扌 口 力
箊	竹 方 人 ⺀
箋	竹 戈 戈
箌	竹 至 刂
箎	竹 虎
箏	竹 爪 彐 亅
箑	竹 一 彐 龰
箒	竹 彐 冖 巾
箓	竹 彐 水
箖	竹 木 木
箘	竹 囗 禾
箙	竹 月 卩 又
箚	竹 合 刂
箛	竹 子 瓜
箞	竹 丷 夫 㔾
箟	竹 日 匕 匕
箠	竹 壬 龷
箣	竹 木 冂 刂
箤	竹 亠 人 十
箥	竹 氵 皮
箮	竹 宀 一 一
箯	竹 亻 一 乂
箰	竹 勹 日 子
箲	竹 氵 ⺧ 儿
箳	竹 尸 䒑 卄
箵	竹 小 丿 目
箶	竹 古 月
箷	竹 方 𠂉 也
箹	竹 糹 勹 丶
箺	竹 𡗗 日
箻	竹 彳 彐 キ
箼	竹 尸 至
箽	竹 千 里
箾	竹 小 月 刂
箿	竹 口 耳
節	竹 彐 厶 卩
篂	竹 日 生
篃	竹 {眉上} 目
範	竹 車 㔾
篅	竹 山 而
篈	竹 土 土 寸
築	竹 工 几 木
篊	竹 氵 龷 八
篋	竹 匚 大 人
篍	竹 禾 火
篎	竹 目 小 丿
篏	竹 卄 二 欠
篐	竹 木 匚 巾
篒	竹 食
篔	竹 口 貝
篕	竹 土 厶 皿
篖	竹 广 肀 口
篗	竹 隹 又
篘	竹 勹 屮 屮
篛	竹 弓 二 二
篜	竹 乛 水 灬
篞	竹 氵 日 土
篟	竹 亻 龶 月
篠	竹 亻 丨 木
篢	竹 工 貝
篣	竹 亠 丷 方
篤	竹 馬
篧	竹 冖 隹
篨	竹 阝 人 木
篩	竹 𠂤 一 巾
篫	竹 工 几 手
篬	竹 人 丶 口
篭	竹 立 电
篯	竹 钅 一 戈
篰	竹 立 口 阝
篲	竹 丰 丰 彐
篳	竹 日 卄 キ
篴	竹 豕 辶
篵	竹 彳 人 龰
篶	竹 一 止 灬
篸	竹 厶 厶 彡
篹	竹 目 大 㔾
篺	竹 扌 {卑上} 十
篻	竹 西 示
篽	竹 彳 𠂉 卩
篿	竹 {專上} 寸
簀	竹 龶 貝
簁	竹 彳 止 龰
簂	竹 囗 戈 一
簃	竹 禾 夕 夕
簄	竹 户 口 巴
簅	竹 立 丿 生
簆	竹 宀 一 又
簈	竹 尸 丿 干
簉	竹 ⺧ 口 辶
簊	竹 其 土
簍	竹 口 十 女
簎	竹 扌 龷 日
簐	竹 車 欠
簑	竹 {京頭} 一 𧘇
簒	竹 目 大 厶
簓	竹 ⺆ 土 彡
簔	竹 亠 一 𧘇
簕	竹 革 力
簗	竹 氵 刀 木
簘	竹 彐 米 {介下}
簙	竹 十 甫 寸
簚	竹 罒 戈 巾
簛	竹 其 斤
簜	竹 氵 日 {两撇}
簝	竹 大 丷 小
簞	竹 口 口 十
簠	竹 甫 皿
簡	竹 門 日
簢	竹 門 文
簣	竹 口 丄 貝
簤	竹 罒 貝
簥	竹 夭 口 口
簨	竹 巳 巳 八
簩	竹 火 火 力
簫	竹 肀 片 一
簬	竹 足 夊 口
簭	竹 工 人 口
簮	竹 夫 夫 日
簯	竹 木 其
簰	竹 片 {卑上} 十
簱	竹 方 其
簲	竹 月 {卑上} 十
簳	竹 十 早 干
簴	竹 {虎头} 业 八
簵	竹 車 夊 口
簶	竹 示 彐 水
簷	竹 冖 厂 言
簹	竹 尚 田
簺	竹 宀 {冓上} 土
簻	竹 咼 辶
簼	竹 扌 {冓上} 土
簽	竹 僉
簾	竹 广 䒑 八
籂	竹 食 𠂉 巾
籃	竹 臣 {⺮右} 皿
籄	竹 匚 口 貝
籅	竹 臼 丂 八
籆	竹 艹 隹 又
籇	竹 {亮頭} 豕
籈	竹 西 土 瓦
籉	竹 士 口 至
籊	竹 习 习 隹
籋	竹 一 八 乂
籌	竹 士 乛 寸
籎	竹 匕 矢 龰
籏	竹 方 𠂉 其
籐	竹 月 丷 水
籑	竹 目 大 艮
籒	竹 扌 丌 田
籓	竹 氵 丿 田
籔	竹 口 十 夊
籕	竹 木 卯 田
籖	竹 十 戈 一
籗	竹 雨 隹
籘	竹 月 丷 糸
籙	竹 金 彐 水
籚	竹 {虎头} 田 皿
籛	竹 金 戈 戈
籜	竹 扌 罒 十
籝	竹 {贏頭} 女
籞	竹 彳 𠂉 示
籟	竹 木 口 貝
籠	竹 立 月 {龍右}
籡	竹 扌 僉
籢	竹 僉 夊
籣	竹 門 木 丷
籤	竹 人 人 一
籥	竹 合 口 冊
籦	竹 金 千 里
籧	竹 {虎头} 豕 辶
籨	竹 僉 欠
籩	竹 自 穴 辶
籪	竹 幺 幺 斤
籫	竹 ⺧ 儿 貝
籬	竹 文 凵 隹
籭	竹 一 {冂丶} 鹿
籮	竹 罒 糹 隹
籯	竹 {贏頭} 貝
籰	竹 目 目 又
籱	竹 雨 隹 隹
籲	竹 合 口 貝
籵	米 十
籶	米 几
籷	米 丿 七
籸	米 乛 十
籹	米 女
籺	米 𠂉 乙
籾	米 刀 丶
籿	米 寸
粀	米 {左上} 乀
粁	米 千
粂	冖 丶 米
粃	米 匕 匕
粄	米 ⺁ 又
粅	米 勹 {两撇}
粆	米 小 丿
粇	米 亠 几
粈	米 丑
粊	匕 匕 米
粋	米 九 十
粌	米 弓 丨
粍	米 毛
粎	米 尸 乀
粏	米 大 丶
粐	米 户
粓	米 卄 二
粔	米 匚 コ
粖	米 末
粙	米 由
粚	米 𠂉 也
粛	彐 米 {介下}
粠	米 龷 八
粡	米 冂 一 口
粣	米 ⺆ ⺆ 一
粦	米 夕 ヰ
粧	米 广 土
粨	米 丆 日
粩	米 耂 匕
粫	米 而
粬	米 冂 龷
粭	米 合
粯	米 見
粰	米 爪 子
粴	米 里
粵	{囟框} 丿 米 丂
粶	米 彐 水
粷	米 勹 米
粸	米 其
粺	米 {卑上} 十
粻	米 長
粿	米 日 木
糀	米 艹 亻 匕
糂	米 其 乚
糃	米 日 一 {两撇}
糄	米 户 冊
糆	米 面
糉	米 乂 凵 夊
糋	米 䒑 月 刂
糎	米 厂 里
糏	米 尸 小 月
糐	米 甫 寸
糑	米 弓 二 二
糒	米 龷 丿 用
糓	{穀頭} 一 米
糔	米 又 丶 虫
糘	米 宀 豕
糚	米 艹 爿 士
糛	米 尚 土
糝	米 厶 厶 彡
糞	米 田 龷 八
糡	米 立 日 儿
糢	米 艹 日 大
糣	米 匚 儿 日
糤	米 龷 月 夊
糥	米 而 而
糦	米 士 口 口
糧	米 日 一 里
糩	米 人 一 日
糪	尸 口 辛 米
糫	米 罒 一 𧘇
糬	米 罒 耂 日
糭	米 𠂭 凵 夊
糮	米 臣 {⺮右} 皿
糰	米 囗 {專上} 寸
糱	屮 𠂤 辛 米
糲	米 厂 艹 禺
糳	业 䒑 十 米
糴	入 米 习 隹
糵	艹 𠂤 辛 米
糶	屮 凵 米 隹
糷	米 艹 門 丷
糹	糹
糺	糹 乚
糼	糹 力
糽	糹 丁
糾	糹 丩
糿	糹 刀
紀	糹 己
紁	糹 又 丶
紂	糹 寸
紃	糹 川
約	糹 勹 丶
紅	糹 工
紆	糹 一 {于下}
紇	糹 𠂉 乙
紈	糹 九 丶
紉	糹 刀 丶
紋	糹 文
紌	糹 尤
納	糹 冂 人
紎	糹 犬
紏	糹 ⺀ 十
紐	糹 丑
紑	糹 不
紒	糹 人 {介下}
紓	糹 予
純	糹 七 凵
紕	糹 匕 匕
紖	糹 弓 丨
紗	糹 小 丿
紘	糹 {左上} 厶
紙	糹 {卬左} 七
級	糹 乃 乀
紛	糹 八 刀
紜	糹 二 厶
紝	糹 壬
紞	糹 冖 儿
紟	糹 人 丶 乛
紡	糹 方
紣	糹 九 十
紤	糹 斤
紥	扌 乚 糸
紦	糹 巴
紨	糹 亻 寸
紩	糹 丿 夫
紪	糹 止 匕
紬	糹 由
紭	糹 弓 厶
紮	木 乚 糸
細	糹 田
紱	糹 {左上} 又 丶
紲	糹 世
紳	糹 申
紴	糹 皮
紵	糹 宀 丁
紶	糹 土 厶
紷	糹 人 丶 マ
紸	糹 丶 王
紹	糹 刀 口
紺	糹 卄 二
紻	糹 冂 大
紼	糹 弓 {介下}
紽	糹 宀 匕
紾	糹 人 彡
紿	糹 厶 口
絀	糹 屮 凵
絁	糹 𠂉 也
終	糹 夊 ⺀
絃	糹 亠 幺
組	糹 且
絅	糹 冂 口
絆	糹 丷 キ
絇	糹 勹 口
絈	糹 白
絉	糹 木 丶
絊	糹 木 一
絋	糹 广 厶
経	糹 又 土
絍	糹 亻 壬
絎	糹 彳 亍
絏	糹 电 丿
結	糹 士 口
絑	糹 牛 八
絒	糹 ⺍ 川
絓	糹 土 土
絔	糹 丆 日
絕	糹 刀 巴
絖	糹 小 兀
絗	糹 囗 口
絘	糹 二 欠
絙	糹 一 日 一
絚	糹 一 月 一
絛	亻 丨 夊 糸
絜	丰 刀 糸
絝	糹 大 一 丂
絞	糹 亠 八 乂
絟	糹 人 王
絠	糹 {左上} 月
絡	糹 夊 口
絢	糹 勹 日
絣	糹 䒑 卄
絤	糹 西
絥	糹 亻 犬
給	糹 合
絧	糹 冂 一 口
絨	糹 戈 {左上}
絩	糹 儿 二 二
絪	糹 囗 大
絫	厶 厶 厶 糸
絬	糹 舌
絭	丷 夫 糸
絯	糹 亥
絰	糹 至
統	糹 亠 厶 儿
絲	糹 糸
絳	糹 夊 ヰ
絴	糹 羊
絵	糹 人 二 厶
絶	糹 冖 巴
絸	糹 見
絹	糹 口 月
絺	糹 乂 {左上} 巾
絻	糹 冖 口 儿
絼	糹 豸
絽	糹 口 口
絾	糹 戊 乛
絿	糹 一 水 丶
綀	糹 木 口
綁	糹 丰 阝
綂	糹 亠 口 儿
綃	糹 小 月
綄	糹 宀 一 兀
綅	糹 彐 冖 又
綆	糹 一 日 乂
綇	糹 酉
綈	糹 丷 弓 丿
綉	糹 禾 乃
綊	糹 大 人 人
綋	糹 宀 {左上} 厶
綌	糹 八 人 口
綍	糹 十 冖 子
綎	糹 壬 廴
綏	糹 爪 女
綐	糹 丷 口 儿
綑	糹 囗 木
綒	糹 爪 子
經	糹 一 巛 工
綔	大 一 丂 糸
綕	糹 士 心
綖	糹 丿 止 廴
綗	糹 冂 八 口
綘	糹 夊 丰
継	糹 米 乚
続	糹 士 冖 儿
綛	糹 刀 丶 心
綜	糹 宀 示
綝	糹 木 木
綞	糹 壬 龷
綟	糹 户 犬
綠	糹 彑 水
綡	糹 {京頭} 小
綢	糹 ⺆ 土 口
綣	糹 丷 夫 㔾
綤	刀 口 阝 糸
綥	糹 田 丌
綧	糹 {京頭} 子
綨	糹 其
綩	糹 宀 夕 㔾
綪	糹 龶 月
綫	糹 戈 戈
綬	糹 爪 冖 又
維	糹 隹
綯	糹 勹 缶
綰	糹 宀 尸 コ
綱	糹 冂 䒑 山
網	糹 冂 䒑 亡
綳	糹 月 月
綴	糹 又 又 又
綵	糹 爪 木
綶	糹 日 木
綷	糹 亠 人 十
綸	糹 人 一 冊
綹	糹 夊 卜 口
綺	糹 大 丁 口
綻	糹 宀 一 龰
綼	糹 {卑上} 十
綽	糹 卜 早
綾	糹 土 八 夊
綿	糹 白 巾
緀	糹 十 彐 女
緁	糹 一 彐 龰
緂	糹 火 火
緃	糹 人 人 龰
緄	糹 日 匕 匕
緅	糹 耳 又
緆	糹 日 勹 {两撇}
緇	糹 巛 田
緈	糹 土 䒑 十
緉	糹 一 巾 入
緊	臣 又 糸
緋	糹 非
緌	糹 禾 女
緍	糹 {卬左} 七 日
緎	糹 戈 口 一
総	糹 八 厶 心
緐	𠂉 母 丿 糸
緑	糹 彐 水
緒	糹 耂 日
緓	糹 艹 冂 大
緔	糹 尚
緕	糹 文 {介下} 二
緖	糹 耂 日 丶
緗	糹 木 目
緘	糹 戊 一 口
緙	糹 革
線	糹 白 水
緛	糹 而 大
緜	白 巾 丿 糸
緝	糹 口 耳
緞	糹 亻 三 殳
緟	糹 千 里
締	糹 亠 丷 巾
緡	糹 巳 七 日
緢	糹 艹 田
緣	糹 {互中} 豕
緤	糹 世 木
緥	糹 亻 口 木
緦	糹 田 心
緧	糹 丷 酉
編	糹 户 冊
緩	糹 爪 干 又
緪	糹 忄 一 一
緫	糹 勹 {两撇} 心
緬	糹 面
緭	糹 田 月
緮	糹 𠂉 日 夊
緯	糹 韋
緰	糹 人 一 刂
緱	糹 亻 コ 矢
緲	糹 目 小 丿
緳	广 丰 刀 糸
練	糹 木 囗 丷
緵	糹 乂 凵 夊
緶	糹 亻 一 乂
緷	糹 冖 車
緸	糹 西 土
緹	糹 日 一 龰
緺	糹 咼
緻	糹 至 夊
緼	糹 日 皿
緽	糹 卜 貝
緾	糹 厂 里
緿	糹 厶 口 心
縀	糹 尸 二 又
縁	糹 彐 豕
縂	糹 丷 口 心
縃	糹 乛 龰 月
縄	糹 日 电
縅	糹 戊 一 女
縆	糹 忄 一 一
縇	糹 宀 一 一
縈	火 火 冖 糸
縉	糹 丌 䒑 日
縊	糹 䒑 八 皿
縋	糹 𠂤 辶
縌	糹 䒑 屮 辶
縍	糹 亠 丷 方
縎	糹 骨
縏	舟 殳 糸
縐	糹 勹 屮 屮
縑	糹 䒑 彐 八
縒	糹 羊 工
縓	糹 厂 白 小
縔	糹 又 又 木
縕	糹 囗 人 皿
縖	糹 宀 丰 口
縗	糹 {京頭} 一 𧘇
縘	糹 爪 幺 大
縙	糹 艹 耳
縚	糹 爪 臼
縛	糹 甫 寸
縜	糹 口 貝
縝	糹 十 且 八
縞	糹 高
縟	糹 辰 寸
縠	{穀頭} 一 糸
縡	糹 宀 辛
縢	月 丷 夫 糸
縣	且 小 丿 糸
縤	糹 龶 糸
縥	糹 𡗗 禾
縦	糹 彳 䒑 龰
縧	糹 亻 丨 木
縨	糹 日 小 兀
縩	糹 {祭上} 示
縪	糹 日 卄 キ
縫	糹 夊 丰 辶
縬	糹 戊 上 小
縭	糹 文 凵 厶
縮	糹 宀 亻 日
縯	糹 宀 一 八
縰	糹 彳 止 龰
縱	糹 彳 人 龰
縲	糹 田 糸
縳	糹 {專上} 寸
縴	糹 亠 幺 牛
縵	糹 日 罒 又
縶	土 䒑 十 糸
縷	糹 口 十 女
縸	糹 艹 日 大
縹	糹 西 示
縺	糹 車 辶
縼	糹 方 𠂉 龰
總	糹 {囟框} 夊 心
績	糹 龶 貝
縿	糹 厶 厶 彡
繀	糹 山 隹
繂	糹 亠 幺 十
繃	糹 山 月 月
繄	匚 矢 殳 糸
繅	糹 巛 日 木
繆	糹 习 习 彡
繈	糹 弓 厶 虫
繉	糹 目 儿 二
繊	糹 十 戈 业
繋	車 殳 糸
繌	糹 {囟框} 乂 夊
繍	糹 彐 米 {介下}
繎	糹 月 犬 灬
繏	糹 巳 巳 八
繐	糹 {專上} 心
繑	糹 夭 口 口
繒	糹 丷 日 日
繓	糹 日 耳 又
織	糹 立 日 戈
繕	糹 羊 䒑 口
繖	糹 龷 月 夊
繗	糹 米 夕 ヰ
繘	糹 予 丿 口
繙	糹 丿 米 田
繚	糹 大 丷 小
繛	龶 糸 卜 早
繜	糹 丷 酉 寸
繝	糹 門 月
繞	糹 土 土 兀
繟	糹 口 口 十
繠	心 心 心 糸
繡	糹 肀 片 一
繢	糹 口 丄 貝
繣	糹 彐 土 一
繤	艹 目 大 糸
繥	糹 士 口 口
繦	糹 弓 口 虫
繧	糹 雨 二 厶
繨	糹 土 羊 辶
繩	糹 黽
繪	糹 人 一 日
繫	車 凵 殳 糸
繬	糹 土 人 口
繭	艹 冂 丨 虫
繮	糹 一 田 一
繯	糹 罒 一 𧘇
繰	糹 口 口 木
繱	糹 艹 勹 心
繲	糹 冖 用 牛
繳	糹 白 方 夊
繴	尸 口 辛 糸
繵	糹 亠 囗 一
繶	糹 立 日 心
繷	糹 冂 龷 辰
繸	糹 䒑 豕 辶
繹	糹 罒 土 十
繺	糹 冖 彐 灬
繻	糹 雨 而
繼	糹 幺 幺 乚
繽	糹 宀 一 貝
繾	糹 口 丄 辶
繿	糹 臣 {⺮右} 皿
纀	糹 亻 业 夫
纁	糹 千 黑
纃	糹 亠 丷 二
纄	糹 艹 夊 辶
纅	糹 白 幺 木
纆	糹 黑 土
纇	米 糸 丆 貝
纈	糹 士 口 貝
纉	糹 夫 夫 貝
纊	糹 广 龷 八
纋	糹 丆 月 夊
續	糹 士 罒 貝
纍	田 田 田 糸
纎	糹 十 戈 一
纏	糹 广 里 土
纐	糹 亠 八 貝
纑	糹 {虎头} 田 皿
纒	糹 厂 里 土
纓	糹 貝 貝 女
纔	糹 冖 口 丶
纕	糹 {京頭} 口 𧘇
纖	糹 人 人 一
纗	糹 山 隹 口
纘	糹 ⺧ 儿 貝
纙	糹 罒 糹 隹
纚	糹 一 {冂丶} 鹿
纜	糹 臣 {⺮右} 見
纝	糹 田 田 糸
纞	糹 言 糹 心
纮	纟 {左上} 厶
纴	纟 壬
纻	纟 宀 一
纼	纟 弓 丨
绖	纟 至
绤	纟 八 人 口
绬	纟 艹 冂 大
绹	纟 勹 缶
缊	纟 日 皿
缐	纟 白 水
缞	纟 {京頭} 一 𧘇
缷	缶 卩
缹	缶 灬
缻	缶 瓦
缼	缶 欠
缽	缶 木 一
缾	缶 䒑 卄
缿	缶 ⺁ 一 口
罀	缶 儿 二 二
罁	缶 冂 䒑 山
罃	火 火 冖 缶
罆	缶 {母框} 十 貝
罇	缶 丷 酉 寸
罈	缶 西 早
罉	缶 尚 手
罊	車 凵 殳 缶
罋	亠 {纟上} 丿 缶
罌	貝 貝 缶
罍	田 田 田 缶
罎	缶 日 雨 厶
罏	缶 {虎头} 田 皿
罒	罒
罓	冂 乂
罖	罒 人 丶
罙	冖 八 木
罛	罒 瓜
罜	罒 丶 王
罝	罒 且
罞	罒 予 丿
罠	罒 巳 七
罣	罒 土 土
罤	罒 丷 弓 丿
罥	罒 口 月
罦	罒 爪 子
罧	罒 木 木
罫	罒 土 土 卜
罬	罒 又 又 又
罭	罒 戈 口 一
罯	罒 立 日
罰	罒 言 刂
罳	罒 田 心
罵	罒 馬
罶	罒 卯 田
罷	罒 厶 月 匕
罸	罒 言 寸
罺	罒 巛 日 木
罻	罒 尸 示 寸
罼	罒 日 卄 キ
罽	罒 厂 火 刂
罿	罒 立 里
羀	冂 乂 乂 田
羂	罒 糹 口 月
羃	罒 艹 日 巾
羄	罒 糹 卜 早
羅	罒 糹 隹
羆	罒 厶 月 灬
羇	罒 革 大 口
羈	罒 革 馬
羉	罒 言 糹 糹
羋	卝 丨 キ
羍	大 羊
羏	羊 彡
羐	卝 土 冖 丶
羑	羊 冖 丶
羒	羊 八 刀
羓	羊 巴
羕	羊 丶 水
羖	羊 殳
羗	羊 乚 厶
羘	月 羊
羙	羊 火
羛	羊 弓 {介下}
羜	羊 宀 丁
羠	羊 大 弓
羢	羊 戈 {左上}
羣	彐 丿 口 羊
羥	羊 一 巛 工
羦	羊 宀 一 兀
羨	羊 氵 欠
義	羊 丿 扌 戈
羪	羊 丶 艮
羫	羊 穴 工
羬	羊 戊 一 口
羭	羊 人 一 刂
羮	羊 灬 一 夫
羱	羊 厂 白 小
羳	羊 丿 米 田
羴	羊 羊 羊
羵	羊 十 卄 貝
羶	羊 亠 囗 一
羷	羊 僉
羺	羊 雨 而
羻	羊 {鹿上} 乛 夊
羾	习 习 工
翀	习 习 口 丨
翂	习 习 八 刀
翃	{左上} 厶 习 习
翄	习 习 十 又
翆	习 习 九 十
翇	习 习 {左上} 丶
翈	甲 习 习
翉	木 一 习 习
翋	习 习 立
翍	习 习 皮
翏	习 习 人 彡
翐	习 习 丿 夫
翑	习 习 勹 口
習	习 习 白
翓	士 口 习 习
翖	合 习 习
翗	夕 夕 习 习
翙	山 夕 习 习
翚	习 习 冖 车
翛	亻 丨 夊 习
翜	习 习 大 人
翝	宀 {左上} 厶 习
翞	习 习 {京頭} 小
翢	⺆ 土 口 习
翣	习 习 立 女
翤	口 冊 习 习
翧	宀 一 日 习
翨	习 习 日 龰
翪	习 习 乂 夊
翫	习 习 白 兀
翬	习 习 冖 車
翭	习 习 亻 矢
翯	习 习 高
翲	西 示 习 习
翴	习 习 車 辶
翵	习 习 鳥
翶	白 二 二 习
翷	米 夕 ヰ 习
翸	十 卄 貝 习
翹	土 土 土 习
翺	自 二 二 习
翽	止 戊 一 习
翾	罒 一 口 习
翿	士 乛 工 习
耂	耂
耇	耂 勹 口
耈	耂 匕 勹 口
耉	耂 丂 口
耊	耂 至
耎	而 大
耏	而 彡
耑	山 而
耓	丰 八 丁
耚	丰 八 皮
耛	丰 八 厶 口
耝	丰 八 且
耞	丰 八 力 口
耟	丰 八 匚 コ
耡	丰 八 且 力
耣	丰 八 人 冊
耤	丰 八 龷 日
耫	丰 八 龶 貝
耬	丰 八 口 女
耭	丰 八 幺 人
耮	丰 八 火 力
耯	丰 八 艹 又
耰	丰 八 丆 夊
耲	丰 八 亠 𧘇
耴	耳 乚
耹	耳 人 丶 乛
耺	耳 二 厶
耼	耳 冂 二
耾	耳 {左上} 厶
聀	耳 戈
聁	耳 八 刀
聄	耳 人 彡
聅	耳 矢
聇	耳 一 止
聈	耳 幺 力
聉	耳 屮 凵
聎	耳 儿 二 二
聏	耳 而
聐	耳 士 口
聑	耳 耳
聓	工 几 丶 耳
聕	耳 ⺧ 口
聖	耳 口 王
聗	耳 大 人 人
聙	耳 龶 月
聛	耳 {卑上} 十
聜	耳 穴 工
聝	耳 戈 口 一
聞	門 耳
聟	矢 口 耳
聠	耳 䒑 卄
聡	耳 八 厶 心
聢	耳 宀 一 龰
聣	耳 臼 儿
聤	耳 {亮頭} 丁
聥	耳 丿 虫 冂
聦	耳 勹 {两撇} 心
聧	耳 癶 一 大
聨	耳 幺 幺 卄
聫	耳 幺 幺 大
聬	耳 八 厶 习
聭	耳 鬼
聮	耳 幺 幺 灬
聯	耳 幺 幺 丱
聰	耳 {囟框} 夊 心
聲	士 {眉上} 殳 耳
聳	彳 人 人 耳
聴	耳 十 罒 心
聵	耳 口 丄 貝
聶	耳 耳 耳
職	耳 立 日 戈
聸	耳 冖 厂 言
聹	耳 宀 心 丁
聺	耳 宀 {祭上} 示
聻	氵 車 斤 耳
聼	乛 耳 十 心
聽	耳 王 十 心
聾	立 月 {龍右} 耳
肁	户 彐 キ
肂	一 夕 彐 キ
肅	肀 片 爿 一
肈	户 戈 彐 キ
肊	月 乙
肍	月 九
肎	冖 月
肏	入 冂 人 人
肐	月 𠂉 乙
肑	月 勹 丶
肒	月 九 丶
肔	月 也
肕	月 刀 丶
肗	月 女
肙	口 月
肞	月 丶 乂
肣	月 人 丶 乛
肦	月 八 刀
肧	月 不
肨	月 丰
肬	月 尤
肰	月 犬
肳	月 勹 {两撇}
肵	月 斤
肶	月 匕 匕
肸	月 八 十
肹	月 八 丂
肻	卜 冖 月
胅	月 丿 夫
胇	月 弓 {介下}
胈	月 {左上} 又 丶
胉	月 白
胊	月 勹 口
胋	月 卜 口
胏	月 丿 ㇉ 丿
胐	月 屮 凵
胑	月 口 八
胒	月 尸 匕
胓	月 干 丷
胔	止 匕 冂 人
胕	月 亻 寸
胘	月 亠 幺
胟	月 母
胠	月 土 厶
胢	月 丁 口
胣	月 𠂉 也
胦	月 冂 大
胮	月 夊 ヰ
胵	月 至
胷	勹 乂 凵 月
胹	月 而
胻	月 彳 亍
胾	十 戈 冂 人
胿	月 土 土
脀	乛 水 一 月
脁	月 儿 二 二
脃	月 冖 巴
脄	月 {左上} 火
脅	力 力 力 月
脇	月 力 力 力
脈	月 ⺁ 𧘇
脋	刀 刀 刀 月
脌	月 𠂉 ヰ
脕	月 冖 口 儿
脗	月 勹 {两撇} 口
脙	月 一 水 丶
脛	月 一 巛 工
脜	月 丆 目
脝	月 {京頭} 了
脟	月 爪 寸
脠	月 丿 止 廴
脡	月 壬 廴
脢	月 𠂉 母
脣	辰 月
脤	月 辰
脥	月 大 人 人
脦	月 弋 心
脧	月 厶 八 夊
脨	月 木 口
脩	亻 丨 夊 月
脪	月 乂 {左上} 巾
脫	月 八 口 儿
脭	月 口 王
脮	月 爪 女
脰	月 一 口 䒑
脳	月 ⺍ 乂 凵
脴	月 不 口
脵	月 口 一 大
脷	月 禾 刂
脹	月 長
脺	月 亠 人 十
脻	月 一 彐 龰
脼	月 一 巾 入
脽	月 隹
脿	月 龶 𧘇
腀	月 人 一 冊
腁	月 丿 干 干
腂	月 日 木
腃	月 丷 夫 㔾
腄	月 壬 龷
腅	月 火 火
腇	月 禾 女
腉	月 臼 儿
腍	月 人 丶 心
腎	臣 又 月
腏	月 又 又 又
腒	月 尸 古
腖	月 木 日
腗	月 由 丌
腘	月 囗 王 丶
腛	月 尸 至
腜	月 卄 二 木
腝	月 而 大
腞	月 {互中} 豕
腟	月 宀 至
腡	月 咼
腢	月 禺
腣	月 亠 丷 巾
腤	月 立 日
腦	月 巛 {囟框} 乂
腨	月 山 而
腪	月 冖 車
腫	月 千 里
腬	月 予 丿 木
腯	月 ⺁ 十 目
腲	月 田 {畏下}
腳	月 八 人 卩
腵	月 尸 二 又
腶	月 亻 三 殳
腷	月 一 口 田
腸	月 日 一 {两撇}
膁	月 䒑 彐 八
膃	月 囗 人 皿
膄	月 臼 丨 又
膅	月 广 肀 口
膆	月 龶 糸
膇	月 𠂤 辶
膉	月 䒑 八 皿
膋	火 火 冖 月
膌	月 二 二 月
膍	月 {囟框} 乂 匕
膎	月 爪 幺 大
膐	方 𠂉 𧘇 人
膒	月 匚 口 口
膓	月 𠂉 日 {两撇}
膔	月 鹿
膕	月 囗 戈 一
膖	月 夊 丰 辶
膗	月 山 隹
膙	月 弓 口 虫
膚	{虎头} 田 月
膞	月 {專上} 寸
膟	月 亠 幺 十
膠	月 习 习 彡
膡	月 丷 夫 目
膢	月 口 十 女
膤	月 雨 彐
膥	末 戊 乛 人
膧	月 立 里
膩	月 弋 二 貝
膫	月 大 丷 小
膬	月 毛 毛 毛
膭	月 口 丄 貝
膮	月 土 土 兀
膯	月 癶 一 䒑
膰	月 丿 米 田
膱	月 立 日 戈
膲	月 隹 灬
膴	月 𠂉 卌 灬
膵	月 艹 亠 十
膶	月 門 王
膷	月 {纟上} 丿 阝
膸	月 {左上} 工 辶
膹	月 十 卄 貝
膼	月 咼 辶
膽	月 冖 厂 言
膾	月 人 一 日
膿	月 冂 龷 辰
臄	月 {虎头} 豕
臅	月 罒 勹 虫
臇	月 隹 {雋下}
臈	月 艹 日 乚
臉	月 僉
臋	尸 龷 八 人
臍	月 亠 丷 二
臎	月 习 习 十
臏	月 宀 一 貝
臐	月 千 黑
臑	月 雨 而
臒	月 艹 隹 又
臓	月 艹 戊 臣
臔	月 臣 又 貝
臕	月 鹿 灬
臖	臼 冂 一 月
臗	月 宀 艹 丶
臘	月 巛 囗 {鼠下}
臙	月 卄 一 灬
臚	月 {虎头} 田 皿
臛	月 雨 隹
臜	月 ⺧ 儿 贝
臝	{贏頭} 日 木
臞	月 目 目 隹
臟	月 艹 戈 臣
臠	言 糹 糹 人
臡	卄 一 口 人
臢	月 ⺧ 儿 貝
臤	臣 又
臥	臣 人
臦	臣 臣
臨	臣 𠂉 口 口
臩	臣 臣 大 {介下}
臫	自 乚
臮	自 亻 人 人
臯	自 二 二 十
臰	自 一 夕 匕
臱	自 穴 方
臲	自 木 冖 㔾
臵	至 夊 口
臶	至 {左上} 丨 子
臷	十 戈 至
臸	至 至
臹	至 戊 乛
臺	士 口 冖 至
臽	冖 臼
臿	千 臼
舃	臼 丂 灬
與	臼 丂 丄 八
興	臼 冂 一 八
舉	臼 丂 丄 キ
舊	艹 隹 臼
舋	臼 冂 一 且
舎	人 土 口
舏	舌 丩
舑	舌 冂 土
舓	舌 日 勹 {两撇}
舕	舌 火 火
舖	人 干 口 甫
舗	人 土 口 甫
舘	人 干 口 コ
舙	舌 舌 舌
舚	舌 冖 厂 言
舝	{五下} 巛 冖 ヰ
舠	舟 刀
舤	舟 几 丶
舥	舟 巴
舦	舟 大 丶
舧	舟 丿 几 丶
舩	舟 八 厶
舮	舟 户
舲	舟 人 丶 マ
舺	舟 甲
舼	舟 龷 八
舽	舟 夊 ヰ
舿	舟 大 一 丂
艀	舟 爪 子
艁	舟 ⺧ 口
艂	舟 夊 丰
艃	舟 里
艅	舟 人 一 木
艆	舟 丶 艮
艈	舟 亠 厶 {荒下}
艊	舟 白 巾
艌	舟 人 丶 心
艍	舟 尸 古
艎	舟 白 王
艐	舟 乂 凵 夊
艑	舟 户 冊
艒	舟 冂 二 目
艓	舟 世 木
艔	舟 广 卄 又
艕	舟 亠 丷 方
艖	舟 羊 工
艗	舟 䒑 八 皿
艙	舟 人 丶 口
艛	舟 口 十 女
艜	舟 卌 一 巾
艝	舟 雨 彐
艞	舟 竹 儿 二
艠	舟 癶 一 䒑
艡	舟 尚 田
艢	舟 土 人 口
艣	舟 {虎头} 田 力
艤	舟 羊 丿 戈
艥	舟 口 耳 戈
艦	舟 臣 {⺮右} 皿
艧	舟 艹 隹 又
艩	舟 亠 丷 二
艪	舟 魚 日
艫	舟 {虎头} 田 皿
艬	舟 冖 口 丶
艭	舟 隹 隹 又
艱	卄 一 口 艮
艵	䒑 卄 冖 巴
艶	冂 龷 一 巴
艷	山 丰 丰 巴
艸	屮 屮
艻	艹 力
艼	艹 丁
芀	艹 刀
芁	艹 几
芃	艹 几 丶
芅	艹 弋
芆	艹 又 丶
芇	艹 巾
芉	艹 干
芌	艹 一 丂
芐	艹 下
芓	艹 子
芔	屮 屮 屮
芕	艹 夕
芖	艹 大
芚	艹 七 凵
芛	艹 彐 丿
芞	艹 气
芠	艹 文
芢	艹 亻 二
芣	艹 不
芧	艹 予
芲	艹 人 匕
芵	艹 コ 人
芶	艹 勹 厶
芺	艹 夭
芻	勹 屮 勹 屮
芼	艹 毛
芿	艹 亻 乃
苀	艹 亠 几
苂	艹 火
苃	艹 {左上} 又
苅	艹 乂 刂
苆	艹 七 刀
苉	艹 兀 乚
苐	艹 弓 丨 丿
苖	艹 由
苙	艹 立
苚	艹 用
苝	艹 丬 匕
苢	艹 尸 コ
苧	艹 宀 丁
苨	艹 尸 匕
苩	艹 白
苪	艹 一 冂 人
苬	艹 囗 人
苭	艹 幺 力
苮	艹 亻 山
苰	艹 弓 厶
苲	艹 𠂉 {乍下}
苳	艹 夊 ⺀
苵	艹 丿 夫
苶	艹 人 小
苸	艹 丿 丷 {于下}
苺	艹 母
苼	艹 生
苽	艹 瓜
苾	艹 心 丿
苿	艹 未
茀	艹 弓 {介下}
茊	艹 斤 一
茋	艹 {卬左} 七 丶
茍	卝 勹 口
茐	艹 勹 {两撇} 丶
茒	艹 夕 阝
茓	艹 穴
茖	艹 夊 口
茘	艹 刀 刀 刀
茙	艹 戈 {左上}
茝	艹 臣
茞	艹 臣
茟	艹 彐 キ
茠	艹 亻 木
茡	艹 宀 子
茢	艹 一 夕 刂
茣	艹 口 一 大
茤	艹 夕 夕
茥	艹 土 土
茦	艹 木 冂
茩	艹 ⺁ 一 口
茪	艹 小 兀
茮	艹 上 小
茰	艹 日 乂
茲	艹 幺 幺
茷	艹 亻 戈
茻	屮 屮 屮 屮
茽	艹 亻 口 丨
茾	艹 一 卄
茿	艹 工 几 丶
荁	艹 一 日 一
荂	艹 大 一 丂
荄	艹 亥
荅	艹 合
荈	艹 夕 ヰ
荊	艹 一 卄 刂
荋	艹 而
荌	艹 宀 女
荍	艹 丩 夊
荎	艹 至
荓	艹 䒑 卄
荕	艹 月 力
荖	艹 耂 匕
荗	艹 戊 丶
荘	艹 丬 士
荙	艹 大 辶
荝	艹 贝 刂
荢	艹 宀 一 {于下}
荰	艹 木 土
荱	艹 尸 毛
荲	艹 里
荳	艹 一 口 䒑
荴	艹 扌 夫
荵	艹 刀 丶 心
荶	艹 口 人 乛
荹	艹 止 小
荺	艹 土 勹 二
荾	艹 厶 八 夊
荿	艹 戊 乛
莀	艹 辰
莁	艹 工 人 人
莂	艹 口 力 刂
莃	艹 乂 {左上} 巾
莄	艹 一 日 乂
莇	艹 且 力
莈	艹 氵 殳
莊	艹 爿 士
莋	艹 亻 𠂉 {乍下}
莌	艹 丷 口 儿
莍	艹 一 水 丶
莏	艹 扌 小 丿
莐	艹 氵 冖 儿
莑	艹 夊 丰
莔	艹 囗 八 冂
莕	艹 木 口
莖	艹 一 巛 工
莗	艹 車
莙	艹 彐 丿 口
莚	艹 丿 止 廴
莝	艹 人 人 土
莟	艹 人 丶 口
莡	艹 足
莢	艹 大 人 人
莣	艹 亡 心
莤	艹 酉
莥	艹 犭 丑
莦	艹 小 月
莧	艹 見
莬	艹 冖 口 儿
莭	艹 彐 厶 卩
莮	艹 田 力
莯	艹 氵 木
莵	艹 {囟框} 儿 丶
莻	艹 乃 口 匕
莾	艹 大 十 卄
莿	艹 木 冂 刂
菂	艹 白 勹 丶
菃	艹 氵 匚 コ
菄	艹 木 日
菆	艹 耳 又
菈	艹 扌 立
菉	艹 彐 水
菋	艹 口 未
菍	艹 人 丶 心
菎	艹 日 匕 匕
菐	业 䒑 夫
菑	艹 巛 田
菒	艹 日 木
菓	艹 日 木
菕	艹 人 一 冊
菗	艹 扌 由
菙	艹 壬 龷
菚	艹 戈 戈
菛	艹 門
菞	艹 禾 勹 丿
菢	艹 扌 勹 巳
菣	艹 臣 又
菤	艹 丷 夫 㔾
菦	艹 斤 辶
菧	艹 广 {卬左} 丶
菨	艹 立 女
菫	艹 一 口 龶
菬	艹 氵 刀 口
菭	艹 氵 厶 口
菮	艹 广 彐 人
華	艹 干 龷
菳	艹 金
菴	艹 大 电
菵	艹 冂 䒑 亡
菶	艹 𡗗 キ
菷	艹 彐 冖 巾
菺	艹 户 月
菻	艹 木 木
菼	艹 火 火
菾	艹 一 大 丶
菿	艹 至 刂
萀	艹 虎
萂	艹 禾 口
萅	艹 七 凵 日
萇	艹 長
萈	艹 見 丶
萉	艹 月 巴
萊	艹 來
萐	艹 一 彐 龰
萒	艹 亠 八 儿
萓	艹 宀 且
萔	艹 扌 刀 口
萕	艹 文 {介下} 二
萖	艹 臼 儿
萗	艹 宀 示
萙	艹 木 冖 儿
萚	艹 扌 又 キ
萛	艹 目 卄
萞	艹 冂 人 匕
萟	艹 禾 九 丶
萠	艹 月 月
萡	艹 氵 白
萢	艹 氵 勹 巳
萣	艹 宀 一 龰
萩	艹 禾 火
萪	艹 禾 ⺀ 十
萫	艹 禾 日
萬	艹 禺
萭	艹 丿 虫 冂
萮	艹 人 一 刂
萯	艹 冖 貝
萰	艹 木 囗 丷
萲	艹 爪 干 又
萳	艹 十 冂 十
萴	艹 貝 刂
萵	艹 咼
萶	艹 𡗗 日
萷	艹 小 月 刂
萹	艹 户 冊
萺	艹 冂 二 目
萻	艹 立 日
萾	艹 乃 又 皿
萿	艹 氵 舌
葀	艹 扌 舌
葁	艹 羊 女
葂	艹 冖 口 力
葃	艹 日 𠂉 {乍下}
葄	艹 月 𠂉 {乍下}
葅	艹 人 人 且
葇	艹 予 丿 木
葈	艹 厶 口 木
葉	艹 世 木
葊	艹 合 卄
葋	艹 月 勹 口
葌	艹 女 女 女
葍	艹 一 口 田
葎	艹 彳 彐 キ
葏	艹 氵 彐 キ
葐	艹 八 刀 皿
葒	艹 糹 工
葓	艹 氵 龷 八
葔	艹 亻 コ 矢
葕	艹 彳 氵 亍
葖	艹 穴 犬
葘	艹 巛 一 田
葝	艹 一 巛 力
葞	艹 弓 耳
葟	艹 白 王
葠	艹 亻 彐 又
葢	艹 大 丶 皿
葤	艹 糹 寸
葥	艹 䒑 月 刂
葦	艹 韋
葧	艹 十 冖 力
葨	艹 田 {畏下}
葪	艹 冖 用 刂
葮	艹 亻 三 殳
葯	艹 糹 勹 丶
葰	艹 亻 厶 夊
葲	艹 白 水
葴	艹 戊 一 口
葷	艹 冖 車
葹	艹 方 𠂉 也
葻	艹 風
葼	艹 乂 凵 夊
葽	艹 西 女
葾	艹 夕 㔾 心
葿	艹 {眉上} 目
蒀	艹 日 皿
蒁	艹 木 丶 辶
蒃	艹 {互中} 豕
蒄	艹 冖 一 寸
蒅	艹 氵 九 木
蒆	艹 工 几 女
蒊	艹 亻 匕 匕
蒍	艹 丶 {爲下}
蒏	艹 冖 酉
蒐	艹 鬼
蒑	艹 ⺁ 彐 殳
蒒	艹 𠂤 一 巾
蒓	艹 糹 七 凵
蒔	艹 日 土 寸
蒕	艹 囗 人 皿
蒖	艹 十 且 八
蒘	艹 女 口 手
蒚	艹 一 口 丨
蒛	艹 缶 コ 人
蒝	艹 厂 白 小
蒞	艹 氵 亻 立
蒟	艹 立 勹 口
蒠	艹 自 心
蒢	艹 阝 人 木
蒣	艹 彳 人 木
蒤	艹 氵 人 木
蒥	艹 卯 田
蒦	艹 隹 又
蒧	艹 戊 卜 口
蒨	艹 亻 龶 月
蒩	艹 禾 且
蒪	艹 甫 寸
蒫	艹 羊 工
蒬	艹 冖 冖 丶
蒭	艹 勹 屮 屮
蒮	艹 冖 隹
蒰	艹 舟 殳
蒱	艹 扌 甫
蒳	艹 糹 冂 人
蒵	艹 爪 幺 大
蒶	艹 糹 八 刀
蒷	艹 口 貝
蒻	艹 弓 二 二
蒼	艹 人 丶 口
蒾	艹 米 辶
蓀	艹 子 丿 糸
蓂	艹 冖 日 八
蓃	艹 臼 丨 又
蓅	艹 氵 亠 {荒下}
蓆	艹 广 卄 巾
蓇	艹 骨
蓈	艹 丶 彐 阝
蓋	艹 土 厶 皿
蓌	艹 人 人 夊
蓎	艹 广 肀 口
蓏	艹 瓜 瓜
蓒	艹 車 干
蓔	艹 羊 灬
蓕	艹 木 土 土
蓗	艹 彳 走
蓘	艹 亠 八 𧘇
蓙	艹 广 人 土
蓚	艹 亻 丨 彡
蓛	艹 木 冂 夊
蓜	艹 酉 己
蓞	艹 爪 臼
蓡	艹 氵 彐 又
蓢	艹 丶 彐 月
蓤	艹 二 土 夊
蓧	艹 亻 丨 木
蓨	艹 亻 丨 月
蓩	艹 予 丿 力
蓪	艹 マ 用 辶
蓫	艹 豕 辶
蓭	艹 广 大 电
蓮	艹 車 辶
蓯	艹 彳 人 龰
蓱	艹 氵 䒑 卄
蓲	艹 匚 口 口
蓳	艹 革 二
蓴	艹 {專上} 寸
蓵	艹 扌 一 龰
蓶	艹 口 隹
蓷	艹 扌 隹
蓸	艹 艹 日 日
蓹	艹 彳 𠂉 卩
蓺	艹 土 八 丶
蓻	艹 土 䒑 丶
蓽	艹 日 卄 キ
蓾	艹 鹵
蔀	艹 立 口 阝
蔁	艹 立 早
蔂	艹 田 糸
蔃	艹 弓 口 虫
蔄	艹 門 口
蔅	艹 門 女
蔆	艹 氵 土 夊
蔇	艹 彐 厶 儿
蔈	艹 西 示
蔉	艹 亠 八 𧘇
蔊	艹 火 日 干
蔋	艹 氵 上 又
蔍	艹 鹿
蔎	艹 言 殳
蔏	艹 亠 丷 口
蔐	艹 亠 丷 古
蔒	艹 彐 丿 灬
蔔	艹 勹 一 田
蔕	艹 卌 一 巾
蔖	艹 {虎头} 且
蔘	艹 厶 厶 彡
蔙	艹 方 𠂉 龰
蔛	艹 冖 用 十
蔜	艹 龶 勹 夊
蔝	艹 目 米
蔞	艹 口 十 女
蔠	艹 糹 夊 ⺀
蔢	艹 氵 皮 女
蔣	艹 爿 月 寸
蔤	艹 宀 心 山
蔥	艹 {囟框} 夊 心
蔦	艹 鳥
蔧	艹 丰 丰 彐
蔨	艹 囗 丷 㔾
蔩	艹 宀 一 八
蔪	艹 車 斤
蔭	艹 阝 人 厶
蔮	艹 囗 戈 一
蔯	艹 阝 木 日
蔰	艹 户 口 巴
蔱	艹 乂 木 殳
蔲	艹 宀 一 夊
蔳	艹 氵 龶 月
蔴	艹 麻
蔵	艹 戊 臣
蔶	艹 龶 貝
蔾	艹 禾 勹 木
蔿	艹 爪 {爲下}
蕀	艹 木 冂 冂
蕁	艹 彐 工 寸
蕂	艹 月 丷 力
蕄	艹 門 心
蕅	艹 氵 禺
蕆	艹 戊 貝
蕇	艹 口 口 十
蕋	艹 止 止 止
蕌	艹 日 日 日
蕍	艹 氵 人 刂
蕎	艹 夭 口 口
蕏	艹 犭 耂 日
蕐	龷 一 人 キ
蕑	艹 門 月
蕒	艹 罒 貝
蕓	艹 雨 二 厶
蕔	艹 土 䒑 又
蕕	艹 犭 丷 酉
蕗	艹 足 夊 口
蕘	艹 土 土 兀
蕚	艹 口 口 丂
蕛	艹 禾 丷 丿
蕜	艹 非 心
蕝	艹 糹 冖 巴
蕟	艹 癶 弓 殳
蕠	艹 女 口 糸
蕡	艹 十 卄 貝
蕢	艹 口 丄 貝
蕣	艹 爪 冖 ヰ
蕥	艹 牙 隹
蕦	艹 彡 丆 貝
蕧	艹 彳 𠂉 夊
蕩	艹 氵 日 {两撇}
蕪	艹 𠂉 卌 灬
蕫	艹 立 里
蕬	艹 糹 糸
蕭	艹 肀 片 一
蕮	艹 臼 勹 灬
蕯	艹 阝 夊 生
蕰	艹 氵 日 皿
蕱	艹 禾 小 月
蕳	艹 門 日
蕵	艹 夕 食
蕶	艹 雨 人 マ
蕷	艹 予 丆 貝
蕸	艹 尸 二 辶
蕼	艹 镸 彐 キ
蕽	艹 冂 龷 辰
蕿	艹 火 爪 又
薀	艹 氵 囗 皿
薁	艹 {向框} 米 大
薂	艹 白 方 夊
薃	艹 氵 高
薆	艹 爪 冖 夊
薈	艹 人 一 日
薉	艹 止 戊 小
薊	艹 魚 刂
薋	艹 二 欠 貝
薌	艹 {纟上} 丿 阝
薍	艹 爪 マ 乚
薎	艹 罒 冖 戈
薐	艹 禾 土 夊
薑	艹 一 田 一
薒	艹 卜 夕 米
薓	艹 氵 彐 又
薔	艹 土 人 口
薕	艹 广 䒑 八
薖	艹 咼 辶
薗	艹 囗 土 𧘇
薘	艹 土 羊 辶
薙	艹 矢 隹
薚	艹 一 夕 {两撇}
薝	艹 冖 厂 言
薞	艹 一 夕 食
薟	艹 僉
薠	艹 火 丆 貝
薡	艹 目 爿 片
薢	艹 冖 用 牛
薣	艹 士 口 又
薥	艹 罒 勹 虫
薦	艹 {鹿上} 丂 灬
薧	艹 {亮頭} 一 匕
薩	艹 阝 立 生
薫	艹 千 里 灬
薬	艹 白 二 木
薭	艹 禾 {卑上} 十
薱	艹 业 羊 寸
薲	艹 宀 一 貝
薳	艹 土 口 辶
薴	艹 宀 心 丁
薵	艹 士 乛 寸
薶	艹 豸 里
薸	艹 氵 西 示
薺	艹 亠 丷 二
薻	艹 氵 巛 木
薼	艹 鹿 土
薽	艹 西 土 瓦
薾	艹 一 八 乂
薿	艹 匕 矢 龰
藀	艹 火 火 火
藂	艹 耳 又 二
藃	艹 高 欠
藄	艹 其 糸
藅	艹 罒 言 刂
藆	艹 宀 {冓上} 手
藇	艹 臼 丂 八
藈	艹 目 癶 大
藊	艹 禾 户 冊
藋	艹 习 习 隹
藌	艹 宀 心 虫
藍	艹 臣 {⺮右} 皿
藎	艹 肀 一 皿
藑	艹 冖 冂 夊
藒	艹 禾 日 乚
藔	艹 宀 大 小
藖	艹 臣 又 貝
藗	艹 木 口 辶
藘	艹 {虎头} 田 心
藙	艹 立 豕 殳
藚	艹 士 罒 貝
藛	艹 宀 臼 灬
藝	艹 土 八 厶
藞	艹 石 石 石
藟	艹 田 田 田
藠	艹 白 白 白
藡	艹 亠 丷 辶
藢	艹 {微上} 一 王
藣	艹 罒 厶 匕
藥	艹 白 幺 木
藦	艹 麻 手
藧	艹 糹 爪 又
藨	艹 鹿 灬
藪	艹 口 十 夊
藫	艹 氵 西 早
藬	艹 阝 口 貝
藭	艹 穴 身 弓
藮	艹 木 隹 灬
藯	艹 尸 示 心
藰	艹 卯 金 刂
藱	艹 疒 鬼
藲	艹 木 匚 口
藳	艹 高 禾
藴	艹 糹 日 皿
藵	艹 亻 口 𧘇
藶	艹 厂 禾 止
藷	艹 言 耂 日
藸	艹 豕 耂 日
藹	艹 言 日 乚
藺	艹 門 隹
藼	艹 宀 丰 心
藽	艹 立 木 見
藾	艹 木 口 貝
蘀	艹 扌 罒 十
蘁	艹 王 口 口
蘂	艹 心 心 木
蘃	艹 止 止 木
蘄	艹 口 口 斤
蘆	艹 {虎头} 田 皿
蘇	艹 魚 禾
蘈	艹 禾 几 貝
蘉	艹 罒 冖 又
蘊	艹 糹 囗 皿
蘋	艹 止 小 貝
蘌	艹 彳 𠂉 示
蘍	艹 千 黑 力
蘎	艹 雨 月 巴
蘏	艹 匕 示 貝
蘐	艹 言 爪 又
蘒	艹 禾 冖 电
蘓	艹 禾 魚
蘔	艹 匕 禾 貝
蘕	艹 糹 夊 辶
蘗	艹 尸 口 木
蘘	艹 {京頭} 口 𧘇
蘙	艹 匚 矢 习
蘚	艹 魚 羊
蘛	艹 其 乚 月
蘜	艹 革 勹 米
蘝	艹 僉 欠
蘞	艹 僉 夊
蘟	艹 阝 爪 心
蘠	艹 爿 土 口
蘡	艹 貝 貝 女
蘢	艹 立 月 {龍右}
蘣	艹 龷 由 王
蘤	艹 白 爪 {爲下}
蘥	艹 合 口 冊
蘦	艹 雨 口 口
蘨	艹 爪 缶 糸
蘪	艹 鹿 米
蘫	艹 氵 臣 皿
蘬	艹 𠂤 止 巾
蘭	艹 門 木 丷
蘮	艹 罒 厂 刂
蘯	艹 氵 日 皿
蘰	艹 糹 日 又
蘱	艹 米 犬 貝
蘲	艹 田 田 土
蘳	艹 龷 由 土
蘴	艹 山 丰 䒑
蘵	艹 耳 立 戈
蘶	艹 禾 女 鬼
蘷	艹 一 止 夊
蘹	艹 忄 亠 𧘇
蘺	艹 文 凵 隹
蘻	艹 車 凵 糸
蘽	艹 田 田 木
蘾	艹 土 亠 𧘇
蘿	艹 罒 糹 隹
虀	艹 亠 丷 一
虁	艹 丆 目 夊
虂	艹 雨 足 口
虃	艹 氵 人 一
虄	艹 虫 夊 生
虅	艹 月 丷 馬
虆	艹 田 田 糸
虇	艹 弓 艹 隹
虈	艹 口 口 口
虉	艹 一 口 鳥
虊	艹 言 糹 木
虋	艹 臼 冂 刀
虌	艹 丷 巾 黽
虒	⺁ 虎
虓	九 虎
處	{虎头} 夊 几
虖	{虎头} 丿 丷 {于下}
虗	{虎头} 斤 一
虘	{虎头} 且
虙	{虎头} 心 丿
虛	{虎头} 丱 一
虜	{虎头} 田 力
虝	虎 勹 {两撇}
號	口 丂 虎
虠	亠 八 乂 虎
虡	{虎头} 业 八
虣	一 弋 止 虎
虤	虎 虎
虥	虎 戈 戈
虦	戈 戈 虎
虧	{虎头} 隹 一 丂
虨	{虎头} 木 木 彡
虩	小 日 小 虎
虪	虎 亻 丨 黑
虭	虫 刀
虯	虫 丩
虰	虫 丁
虲	虫 卜
虳	虫 勹 丶
虴	虫 丿 七
虵	虫 也
虶	虫 一 {于下}
虷	虫 干
虸	虫 子
蚃	{纟上} 丿 虫
蚄	虫 方
蚅	虫 厂 㔾
蚆	虫 巴
蚇	虫 尸 乀
蚈	虫 一 卄
蚉	文 虫
蚎	虫 日
蚏	虫 月
蚐	虫 勹 二
蚑	虫 十 又
蚒	虫 ⺆ 亠
蚔	虫 {卬左} 七
蚖	虫 一 兀
蚗	虫 コ 人
蚘	虫 尤
蚙	虫 人 丶 乛
蚚	虫 斤
蚛	虫 口 丨
蚞	虫 木
蚟	虫 王
蚠	八 刀 虫
蚡	虫 八 刀
蚢	虫 亠 几
蚥	虫 八 乂
蚦	虫 冂 二
蚫	虫 勹 巳
蚭	虫 尸 匕
蚮	虫 亻 弋
蚲	虫 干 丷
蚳	虫 {卬左} 七 丶
蚷	虫 匚 コ
蚸	虫 斤 丶
蚹	虫 亻 寸
蚻	木 乚 虫
蚼	虫 勹 口
蚽	虫 不 一
蚾	虫 皮
蚿	虫 亠 幺
蛁	虫 刀 口
蛂	虫 {左上} 又 丶
蛃	虫 一 冂 人
蛅	虫 卜 口
蛈	虫 丿 夫
蛌	虫 瓜
蛍	⺍ 冖 虫
蛒	虫 夊 口
蛓	十 戈 虫
蛕	虫 {左上} 月
蛖	虫 尤 彡
蛗	𠂤 虫
蛚	虫 一 夕 刂
蛜	虫 亻 彐 丿
蛝	虫 艮
蛠	虫 力 力 力
蛡	虫 习 习
蛢	虫 䒑 卄
蛣	虫 士 口
蛥	虫 夕 夕
蛦	虫 大 弓
蛧	虫 冂 乂 乂
蛨	虫 丆 日
蛪	丰 刀 虫
蛫	虫 冖 厂 㔾
蛬	龷 八 虫
蛯	虫 耂 匕
蛵	虫 一 巛 工
蛶	虫 爪 寸
蛷	虫 一 水 丶
蛺	虫 大 人 人
蛻	虫 八 口 儿
蛼	虫 車
蛽	虫 貝
蛿	虫 人 丶 口
蜁	虫 𠂉 乛 龰
蜄	虫 辰
蜅	虫 甫
蜆	虫 見
蜋	虫 丶 艮
蜌	虫 匕 匕 土
蜎	虫 口 月
蜏	虫 禾 乃
蜐	虫 土 厶 力
蜑	丿 止 廴 虫
蜔	虫 勹 田
蜖	虫 囗 〢 二
蜙	虫 木 八 厶
蜛	虫 尸 古
蜝	其 虫
蜟	虫 亠 厶 月
蜠	虫 囗 禾
蜤	木 斤 虫
蜦	虫 人 一 冊
蜧	虫 户 犬
蜨	虫 一 彐 龰
蜪	虫 勹 缶
蜫	虫 日 匕 匕
蜬	虫 乛 水 凵
蜭	虫 冖 臼
蜯	虫 𡗗 キ
蜰	月 巴 虫
蜲	虫 禾 女
蜳	虫 {京頭} 子
蜵	虫 片 爿 一
蜶	虫 亠 人 十
蜸	臣 又 虫
蜹	虫 艹 冂 人
蜺	虫 臼 儿
蜼	虫 隹
蜽	虫 一 巾 入
蝀	虫 木 日
蝁	一 {亞下} 虫
蝂	虫 片 ⺁ 又
蝃	虫 又 又 又
蝄	虫 冂 䒑 亡
蝅	一 大 一 虫
蝆	虫 卝 キ
蝊	虫 宀 一 龰
蝋	虫 ⺍ 几 キ
蝍	虫 彐 厶 卩
蝏	虫 {亮頭} 丁
蝐	虫 冂 二 目
蝑	虫 乛 龰 月
蝒	虫 面
蝔	虫 匕 匕 白
蝕	食 虫
蝖	虫 宀 一 一
蝘	虫 匚 日 女
蝚	虫 予 丿 木
蝛	虫 戊 一 女
蝜	虫 冖 貝
蝝	虫 {互中} 豕
蝞	虫 {眉上} 目
蝟	虫 田 月
蝡	虫 而 大
蝢	虫 丆 貝
蝦	虫 尸 二 又
蝧	虫 艹 冂 大
蝨	乛 十 虫 虫
蝩	虫 千 里
蝪	虫 日 一 {两撇}
蝫	虫 耂 日
蝬	虫 乂 凵 夊
蝭	虫 日 一 龰
蝯	虫 爪 干 又
蝱	亡 虫 虫
蝲	虫 木 口 刂
蝳	虫 龶 母
蝵	禾 火 虫
蝷	虫 广 䒑 屮
蝸	虫 咼
蝹	虫 日 皿
蝺	虫 丿 虫 冂
蝿	虫 日 电
螀	丬 夕 寸 虫
螁	虫 艮 辶
螄	虫 𠂤 一 巾
螆	虫 䒑 幺 幺
螇	虫 爪 幺 大
螉	虫 八 厶 习
螊	虫 䒑 彐 八
螌	舟 殳 虫
螎	虫 一 口 丨
螏	虫 疒 矢
螐	虫 烏
螑	虫 自 犬
螒	十 早 人 虫
螔	虫 ⺁ 虎
螕	虫 {囟框} 乂 匕
螖	虫 骨
螘	虫 山 一 䒑
螙	木 虫 虫
螚	厶 月 匕 虫
螛	虫 宀 丰 口
螜	{穀頭} 一 虫
螝	虫 鬼
螞	虫 馬
螠	虫 䒑 八 皿
螡	文 虫 虫
螢	火 火 冖 虫
螣	月 丷 夫 虫
螤	文 虫 日 人
螥	虫 人 丶 口
螦	虫 龶 糸
螧	虫 耂 匕 日
螩	虫 亻 丨 木
螪	虫 亠 丷 口
螮	虫 卌 一 巾
螰	虫 鹿
螱	尸 示 寸 虫
螲	虫 穴 至
螴	阝 木 日 虫
螶	匚 コ 虫 虫
螷	广 {卑上} 十 虫
螸	八 人 口 虫
螹	虫 車 斤
螻	虫 口 十 女
螼	虫 革 二
螾	虫 宀 一 八
螿	爿 月 寸 虫
蟁	巳 七 虫 虫
蟂	虫 {鳥上} 木
蟃	虫 日 罒 又
蟄	土 䒑 十 虫
蟅	虫 广 卄 灬
蟇	艹 日 大 虫
蟈	虫 囗 戈 一
蟉	虫 习 习 彡
蟌	虫 {囟框} 夊 心
蟍	虫 禾 刂 木
蟎	虫 卄 一 入
蟏	虫 艹 肀 八
蟐	虫 尚 巾
蟔	虫 黑
蟕	虫 止 匕 用
蟖	虫 其 斤
蟗	十 口 冖 虫
蟘	虫 亻 弋 貝
蟙	虫 立 日 戈
蟚	士 口 䒑 虫
蟜	虫 夭 口 口
蟝	虫 氵 匚 木
蟞	丷 巾 八 虫
蟟	虫 大 丷 小
蟡	虫 爪 {爲下}
蟢	虫 士 口 口
蟣	虫 幺 幺 人
蟤	虫 巳 巳 八
蟦	虫 十 卄 貝
蟧	虫 火 火 力
蟨	厂 䒑 屮 虫
蟩	虫 厂 䒑 欠
蟫	虫 西 早
蟬	虫 口 口 十
蟭	虫 隹 灬
蟯	虫 土 土 兀
蟰	虫 肀 片 一
蟱	虫 𠂉 卌 灬
蟲	虫 虫 虫
蟳	虫 彐 工 寸
蟴	其 斤 虫
蟵	虫 厂 一 寸
蟶	虫 耳 口 王
蟷	虫 尚 田
蟸	豕 虫 虫
蟺	虫 亠 囗 一
蟻	虫 羊 丿 戈
蟼	艹 勹 口 虫
蟽	虫 土 羊 辶
蟿	車 凵 殳 虫
蠀	虫 二 欠 貝
蠁	{纟上} 丿 丶 虫
蠂	虫 艹 世 木
蠄	虫 人 文 厶
蠅	虫 黽
蠆	艹 禺 虫
蠇	虫 艹 禺
蠈	貝 戈 {左上} 虫
蠉	虫 罒 一 𧘇
蠋	虫 罒 勹 虫
蠌	虫 罒 土 十
蠍	虫 日 勹 欠
蠎	虫 艹 大 卄
蠏	虫 冖 用 牛
蠐	虫 亠 丷 二
蠑	虫 火 火 木
蠒	一 八 巾 虫
蠔	虫 {亮頭} 豕
蠗	虫 习 习 隹
蠘	虫 十 戈 隹
蠙	虫 宀 一 貝
蠚	艹 {左上} 口 虫
蠜	木 乂 乂 虫
蠝	虫 田 田 田
蠞	竹 彐 厶 虫
蠟	虫 巛 囗 {鼠下}
蠠	面 虫 虫
蠣	虫 厂 艹 禺
蠤	丷 酉 虫 虫
蠥	屮 𠂤 辛 虫
蠦	虫 {虎头} 田 皿
蠧	士 冖 石 虫
蠨	虫 艹 肀 一
蠩	虫 言 耂 日
蠪	立 月 {龍右} 虫
蠫	豸 刂 虫 虫
蠬	虫 立 月 {龍右}
蠭	夊 丰 辶 虫
蠮	虫 匚 矢 习
蠯	广 {卑上} 十 虫
蠰	虫 {京頭} 口 𧘇
蠱	虫 虫 虫 皿
蠳	虫 貝 貝 女
蠴	虫 艹 罒 日
蠵	虫 山 隹 口
蠶	匚 儿 匚 虫
蠷	虫 目 目 隹
蠸	虫 艹 口 隹
蠺	一 大 一 虫
蠻	言 糹 糹 虫
蠽	小 隹 戈 虫
蠾	虫 尸 水 虫
蠿	幺 幺 一 虫
衁	亡 丿 皿
衂	丿 皿 刀 丶
衃	丿 皿 不
衆	丿 皿 亻 二
衇	丿 皿 ⺁ 𧘇
衈	丿 皿 耳
衉	丿 皿 夊 口
衊	丿 皿 艹 丶
衋	彐 キ 丆 皿
衎	彳 干 亍
衏	彳 一 兀 亍
衐	彳 匚 コ 亍
衑	彳 人 丶 亍
衒	彳 亠 幺 亍
術	彳 木 丶 亍
衕	彳 冂 一 亍
衖	彳 龷 八 亍
衘	彳 𠂉 一 亍
衚	彳 古 月 亍
衛	彳 韋 亍
衜	彳 䒑 自 亍
衝	彳 千 里 亍
衞	彳 {五下} 口 亍
衟	彳 巛 丆 亍
衠	彳 十 且 亍
衦	衤 干
衧	衤 一 {于下}
衪	衤 也
衭	衤 夫
衯	衤 八 刀
衱	衤 乃 乀
衳	衤 八 厶
衴	衤 冖 儿
衵	衤 日
衶	衤 口 丨
衸	衤 人 {介下}
衹	衤 {卬左} 七
衺	亠 牙 𧘇
衻	衤 冂 二
衼	衤 十 又
袀	衤 勹 二
袃	七 刀 亠 𧘇
袆	衤 キ 乛
袇	衤 ⺆ 亠
袉	衤 宀 匕
袊	衤 人 丶 マ
袌	亠 勹 巳 𧘇
袎	衤 幺 力
袏	衤 {左上} 工
袐	衤 心 丿
袑	衤 刀 口
袓	衤 且
袔	衤 丁 口
袕	衤 穴
袗	衤 人 彡
袘	衤 𠂉 也
袙	衤 白
袚	衤 {左上} 又 丶
袛	衤 {卬左} 七 丶
袝	衤 亻 寸
袞	亠 八 口 𧘇
袟	衤 丿 夫
袠	亠 丿 夫 𧘇
袡	衤 冂 土
袣	衤 世
袥	衤 石
袦	衤 屮 凵
袧	衤 勹 口
袨	衤 亠 幺
袩	衤 卜 口
袪	衤 土 厶
袬	亠 厶 口 𧘇
袮	衤 𠂉 小
袯	衤 丩 又 丶
袰	母 亠 𧘇
袲	亠 夕 夕 𧘇
袳	衤 夕 夕
袴	衤 大 一 丂
袵	衤 亻 壬
袶	衤 夊 ヰ
袸	衤 {左上} 丨 子
袹	衤 丆 日
袺	衤 士 口
袻	衤 而
袽	衤 女 口
袾	衤 牛 八
袿	衤 土 土
裀	衤 囗 大
裃	衤 上 下
裄	衤 彳 亍
裇	衤 丿 皿
裈	衤 冖 车
裊	{鳥上} 亠 𧘇
裋	衤 一 口 䒑
裌	衤 大 人 人
裍	衤 囗 木
裏	亠 里 𧘇
裐	衤 口 月
裑	衤 身
裓	衤 戈 卄
裖	衤 辰
裗	衤 亠 厶 {荒下}
裚	扌 斤 亠 𧘇
裛	亠 口 巴 𧘇
補	衤 甫
裝	爿 士 亠 𧘇
裞	衤 丷 口 儿
裠	彐 丿 口 𧘇
裡	衤 里
裦	亠 {卬左} 一 𧘇
裧	衤 火 火
裩	衤 日 匕 匕
裪	衤 勹 缶
裫	衤 片 爿 一
裬	衤 土 八 夊
裭	衤 虎
裮	衤 日 日
裯	衤 ⺆ 土 口
裲	衤 一 巾 入
裵	亠 非 𧘇
裶	衤 非
裷	衤 丷 夫 㔾
裺	衤 大 电
裻	上 小 又 𧘇
製	牛 冂 刂 𧘇
裿	衤 大 丁 口
褀	衤 其
褁	日 木 𧘇
褃	衤 止 月
褄	衤 十 彐 女
褅	衤 亠 丷 巾
褆	衤 日 一 龰
複	衤 𠂉 日 夊
褈	衤 千 里
褉	衤 丰 刀 大
褋	衤 世 木
褌	衤 冖 車
褍	衤 山 而
褎	亠 {卬左} 一 𧘇
褏	亠 {卬左} 一 𧘇
褑	衤 爪 干 又
褔	衤 一 口 田
褕	衤 人 一 刂
褖	衤 {互中} 豕
褗	衤 匚 日 女
褘	衤 韋
褜	月 勹 巳 𧘇
褝	衤 ⺍ 日 十
褞	衤 日 皿
褟	衤 日 习 习
褠	衤 {冓上} 冂 土
褢	亠 鬼 𧘇
褣	衤 穴 人 口
褤	衤 土 口 𧘇
褦	衤 厶 月 匕
褧	耳 火 亠 𧘇
褨	衤 羊 工
褩	舟 殳 亠 𧘇
褬	衤 又 又 木
褭	亠 馬 𧘇
褮	火 火 冖 𧘇
褯	衤 广 卄 巾
褱	亠 罒 水 𧘇
褲	衤 广 車
褳	衤 車 辶
褵	衤 文 凵 厶
褷	衤 彳 止 龰
褸	衤 口 十 女
褹	衤 土 八 丶
褺	土 䒑 十 𧘇
褻	亠 土 八 𧘇
褼	衤 西 大 巳
褽	尸 示 寸 𧘇
褾	衤 西 示
褿	衤 艹 日 日
襀	衤 龶 貝
襂	衤 厶 厶 彡
襃	亠 {卬左} 一 𧘇
襅	衤 日 卄 キ
襆	衤 业 䒑 夫
襇	衤 門 日
襈	衤 巳 巳 八
襉	衤 門 月
襊	衤 日 耳 又
襋	衤 木 冂 冂
襌	衤 口 口 十
襍	衤 隹 木
襎	衤 丿 米 田
襏	衤 癶 弓 殳
襐	衤 冖 口 豕
襑	衤 彐 工 寸
襒	衤 丷 巾 夊
襓	衤 土 土 兀
襔	衤 卄 一 入
襕	衤 门 木 丷
襖	衤 {向框} 米 大
襗	衤 罒 土 十
襘	衤 人 一 日
襙	衤 口 口 木
襚	衤 䒑 豕 辶
襛	衤 冂 龷 辰
襜	衤 冖 厂 言
襝	衤 僉
襠	衤 尚 田
襡	衤 罒 勹 虫
襢	衤 亠 囗 一
襣	衤 自 田 丌
襤	衤 臣 {⺮右} 皿
襥	衤 亻 业 夫
襧	衤 一 八 乂
襨	衤 业 羊 寸
襩	衤 士 罒 貝
襪	衤 艹 罒 丶
襫	衤 大 丆 日
襬	衤 罒 厶 匕
襭	衤 士 口 貝
襮	衤 日 龷 水
襯	衤 立 木 見
襰	衤 木 口 貝
襱	衤 立 月 {龍右}
襲	立 月 {龍右} 𧘇
襳	衤 人 人 一
襴	衤 門 木 丷
襵	衤 耳 耳 耳
襶	衤 十 戈 八
襷	衤 臼 丂 手
襸	衤 ⺧ 儿 貝
襹	衤 一 {冂丶} 鹿
襺	衤 艹 冂 虫
襼	衤 艹 土 厶
襽	衤 艹 門 丷
襾	襾
覀	西
覂	西 丿 之
覄	西 亻 犬
覅	西 女 勹 {两撇}
覇	西 革 月
覈	西 白 方 夊
覉	西 革 大 口
覊	西 革 馬
見	見
覌	又 見
覍	小 見
覎	見 子
規	夫 見
覐	見 乂 乂
覑	片 見
覒	毛 見
覓	爪 見
覔	不 見
覕	心 丿 見
視	示 見
覗	乛 一 口 見
覘	卜 口 見
覙	冖 小 見
覚	⺍ 冖 見
覛	⺁ 𧘇 見
覜	儿 二 二 見
覝	干 火 見
覞	見 見
覟	士 心 見
覠	彐 丿 口 見
覡	工 人 人 見
覢	火 火 見
覣	禾 女 見
覤	虎 見
覥	冂 龷 八 見
覦	人 一 月 見
覧	臣 {⺮右} 見
覨	口 口 一 見
覩	耂 日 見
親	立 木 見
覫	亠 丷 冖 見
覬	山 一 口 見
覭	冖 日 亠 見
覮	火 火 冖 見
覯	{冓上} 冂 土 見
覰	{虎头} 且 見
覱	車 斤 見
覲	革 二 見
観	𠂉 一 隹 見
覴	癶 一 口 見
覵	門 月 見
覶	爪 マ 冂 見
覷	{虎头} 业 見
覸	門 日 見
覹	見 {微上} 一 几
覺	臼 乂 乂 見
覻	{虎头} 一 口 見
覼	一 八 巾 見
覽	臣 {⺮右} 罒 見
覾	宀 丿 米 見
覿	士 罒 貝 見
觀	艹 口 口 見
觃	见 子
觍	冂 龷 八 见
觓	冖 用 丩
觔	冖 用 力
觕	牛 冖 用
觗	冖 用 {卬左} 七
觘	冖 用 小 丿
觙	冖 用 乃 乀
觛	冖 用 日 一
觝	冖 用 {卬左} 丶
觟	冖 用 土 土
觠	丷 夫 冖 用
觡	冖 用 夊 口
觢	丰 刀 冖 用
觤	冖 用 冖 㔾
觧	冖 用 羊
觨	冖 用 工 水
觩	冖 用 一 丶
觪	冖 用 辛
觬	冖 用 臼 儿
觭	冖 用 大 口
觮	冖 用 彐 水
觰	冖 用 耂 日
觱	戊 一 口 用
觲	冖 用 羊 牛
觴	冖 用 𠂉 {两撇}
觵	冖 用 龷 八
觶	冖 用 口 十
觷	臼 乂 乂 用
觸	冖 用 罒 虫
觹	冖 用 隹 {雋下}
觺	匕 矢 マ 用
觻	冖 用 白 木
觼	冖 用 冖 夊
觽	冖 用 山 {雋下}
觾	冖 用 卄 灬
觿	冖 用 山 口
訁	言
訂	言 丁
訃	言 卜
訄	九 言
訅	言 九
訆	言 丩
計	言 十
訉	言 几 丶
訊	言 乛 十
訋	言 勹 丶
訌	言 工
訍	言 又 丶
討	言 寸
訏	言 一 {于下}
訐	言 干
訑	言 也
訒	言 刀 丶
訓	言 川
訔	山 言
訕	言 山
訖	言 𠂉 乙
託	言 丿 七
記	言 己
訙	言 九 丶
訚	门 言
訛	言 亻 匕
訜	言 八 刀
訝	言 牙
訞	言 夭
訟	言 八 厶
訠	言 弓 丨
訡	言 人 丶 乛
訢	言 斤
訣	言 コ 人
訤	言 乂 乂
訥	言 冂 人
訦	言 冖 儿
訧	言 尤
訨	言 止
訩	言 乂 凵
訪	言 方
訫	言 心
訬	言 小 丿
設	言 殳
訮	言 一 卄
訯	言 乃 乀
訰	言 七 凵
許	言 𠂉 十
訲	言 口 丨
訳	言 尸 乀
訴	言 斤 丶
訵	言 囗 儿
訶	言 丁 口
訷	言 申
訸	言 禾
訹	言 木 丶
診	言 人 彡
註	言 丶 王
証	言 一 止
訽	言 勹 口
訿	言 止 匕
詀	言 卜 口
詁	言 古
詂	言 亻 寸
詃	言 亠 幺
詄	言 丿 夫
詅	言 人 丶 マ
詆	言 {卬左} 七 丶
詇	言 冂 大
詉	言 女 又
詊	言 丷 キ
詋	言 口 儿
詌	言 卄 二
詍	言 世
詎	言 匚 コ
詏	言 幺 力
詐	言 𠂉 {乍下}
詑	言 宀 匕
詒	言 厶 口
詓	言 土 厶
詔	言 刀 口
評	言 干 丷
詖	言 皮
詗	言 冂 口
詘	言 屮 凵
詙	言 {左上} 又 丶
詚	言 日 一
詛	言 且
詜	言 屮 又
詝	言 宀 丁
詞	言 乛 一 口
詟	尤 丿 言
詠	言 丶 水
詡	言 习 习
詢	言 勹 日
詣	言 匕 日
詤	言 人 乚 {荒下}
詥	言 合
試	言 弋 工
詧	{祭上} 言
詨	言 亠 八 乂
詩	言 土 寸
詪	言 艮
詫	言 宀 丿 七
詬	言 ⺁ 一 口
詭	言 冖 厂 㔾
詮	言 人 王
詯	言 自
詰	言 士 口
話	言 舌
該	言 亥
詳	言 羊
詴	言 {左上} 月
詵	言 ⺧ 儿
詶	言 ⺍ 川
詷	言 冂 一 口
詸	言 米
詺	言 夕 口
詻	言 夊 口
詼	言 {左上} 火
詽	言 干 干
詾	言 勹 乂 凵
詿	言 土 土
誀	言 耳
誁	言 䒑 卄
誂	言 儿 二 二
誃	言 夕 夕
誄	言 丰 八
誅	言 牛 八
誆	言 匚 王
誇	言 大 一 丂
誈	言 至
誋	言 己 心
誌	言 士 心
認	言 刀 丶 心
誎	言 木 口
誏	言 丶 艮
誐	言 丿 扌 戈
誑	言 犭 王
誒	言 厶 矢
誔	言 壬 廴
誕	言 丿 止 廴
誖	言 十 冖 子
誗	言 禾 刂
誘	言 禾 乃
誙	言 一 巛 工
誚	言 小 月
誛	言 彐 冖 又
誜	言 厶 八 夊
誝	言 人 丶 口
語	言 一 {五下} 口
誟	言 耂 子
誠	言 戊 乛
誡	言 戈 卄
誢	言 見
誣	言 工 人 人
誤	言 口 一 大
誥	言 ⺧ 口
誦	言 マ 用
誧	言 甫
誨	言 𠂉 母
誩	言 言
說	言 八 口 儿
誫	言 辰
説	言 丷 口 儿
読	言 士 冖 儿
誮	言 艹 亻 匕
誯	言 日 日
誰	言 隹
誱	言 一 彐 龰
課	言 日 木
誳	言 尸 屮 凵
誴	言 宀 示
誵	言 乂 {左上} 月
誶	言 亠 人 十
誷	言 冂 䒑 亡
誸	言 弓 亠 幺
誹	言 非
誺	言 來
誻	言 水 日
誼	言 宀 且
誽	言 臼 儿
誾	門 言
調	言 ⺆ 土 口
諀	言 {卑上} 十
諁	言 又 又 又
諂	言 冖 臼
諃	言 木 木
諄	言 {京頭} 子
諅	其 言
諆	言 其
談	言 火 火
諈	言 壬 龷
諉	言 禾 女
諊	言 勹 米
請	言 龶 月
諌	言 木 日
諍	言 冖 彐 亅
諎	言 龷 日
諏	言 耳 又
諐	亻 口 {荒下} 言
諑	言 豕 丶
諒	言 {京頭} 小
諓	言 戈 戈
諔	言 上 小 又
諕	言 虎
論	言 人 一 冊
諗	言 人 丶 心
諘	言 龶 𧘇
諙	言 {卬左} 七 日
諚	言 宀 一 龰
諛	言 臼 人
諜	言 世 木
諝	言 乛 龰 月
諞	言 户 冊
諟	言 日 一 龰
諠	言 宀 一 一
諡	言 八 丂 皿
諢	言 冖 車
諣	言 咼
諤	言 口 口 丂
諥	言 千 里
諦	言 亠 丷 巾
諧	言 匕 匕 白
諨	言 一 口 田
諩	言 䒑 业
諪	言 {亮頭} 丁
諫	言 木 囗 丷
諬	禾 尤 言
諭	言 人 一 刂
諮	言 二 欠 口
諯	言 山 而
諰	言 田 心
諱	言 韋
諲	言 西 土
諳	言 立 日
諴	言 戊 一 口
諵	言 十 冂 十
諶	言 其 乚
諷	言 風
諸	言 耂 日
諹	言 日 一 {两撇}
諺	言 立 丿 彡
諻	言 白 王
諼	言 爪 干 又
諽	言 革
諾	言 艹 {左上} 口
諿	言 口 耳
謀	言 卄 二 木
謁	言 日 勹 乚
謂	言 田 月
謃	言 日 生
謄	月 丷 夫 言
謅	言 勹 屮 屮
謆	言 户 习 习
謈	日 龷 八 言
謉	言 鬼
謊	言 艹 亡 {荒下}
謋	言 夕 ヰ 木
謌	言 丁 口 口
謍	火 火 冖 言
謎	言 米 辶
謏	言 臼 丨 又
謐	言 心 丿 皿
謑	言 爪 幺 大
謒	言 人 丶 口
謓	言 十 且 八
謔	言 {虎头} {反彐}
謕	言 ⺁ 虎
謖	言 田 八 夊
謗	言 亠 丷 方
謘	言 尸 辛
謙	言 䒑 彐 八
謚	言 䒑 八 皿
講	言 {冓上} 冂 土
謜	言 厂 白 小
謝	言 身 寸
謞	言 高
謟	言 爪 臼
謠	言 月 缶
謡	言 爪 缶
謢	言 隹 又
謣	言 雨 一 丂
謤	言 西 示
謥	言 {囟框} 夊 心
謧	言 文 凵 厶
謨	言 艹 日 大
謩	艹 日 大 言
謪	言 亠 丷 口
謫	言 亠 丷 古
謬	言 习 习 彡
謭	言 䒑 月 刀
謮	言 龶 貝
謯	言 {虎头} 且
謰	言 車 辶
謱	言 口 十 女
謲	言 厶 厶 彡
謳	言 匚 口 口
謴	言 {母框} 十 貝
謵	言 习 习 白
謶	言 广 卄 灬
謷	龶 勹 夊 言
謸	言 龶 勹 夊
謹	言 革 二
謺	土 䒑 十 言
謻	言 禾 夕 夕
謼	言 {虎头} 丿 {于下}
謽	弓 口 虫 言
謾	言 日 罒 又
謿	言 十 早 月
譀	言 乛 耳 夊
譁	言 艹 干 龷
譂	言 口 口 十
譃	言 {虎头} 业
譄	言 丷 日 日
譅	言 刀 丶 止
譆	言 士 口 口
譇	言 大 耂 日
譈	言 {京頭} 子 夊
證	言 癶 一 䒑
譊	言 土 土 兀
譋	言 門 月
譌	言 爪 {爲下}
譍	广 亻 隹 言
譎	言 予 丿 口
譏	言 幺 幺 人
譐	言 丷 酉 寸
譑	言 夭 口 口
譒	言 丿 米 田
譓	言 {專上} 心
譔	言 巳 巳 八
譕	言 𠂉 卌 灬
譖	言 匚 儿 日
譗	言 竹 合
識	言 立 日 戈
譙	言 隹 灬
譚	言 西 早
譛	言 夫 夫 日
譜	言 䒑 业 日
譝	言 黽
譞	言 罒 一 𧘇
譟	言 口 口 木
譠	言 亠 囗 一
譡	言 尚 田
譢	言 䒑 豕 辶
譣	言 僉
譤	言 白 方 夊
譥	白 方 夊 言
譧	言 广 䒑 八
譨	言 冂 龷 辰
譩	言 立 日 心
譪	言 艹 日 乚
譫	言 冖 厂 言
譭	言 臼 工 殳
譮	言 人 一 日
譯	言 罒 土 十
議	言 羊 丿 戈
譱	羊 言 言
譲	言 亠 八 𧘇
譳	言 雨 而
譴	言 口 丄 辶
譵	言 业 羊 寸
譶	言 言 言
護	言 艹 隹 又
譸	言 士 乛 寸
譹	言 {亮頭} 豕
譺	言 匕 矢 龰
譻	貝 貝 言
譼	臣 {⺮右} 罒 言
譽	臼 丂 丄 言
譾	言 䒑 月 习
譿	言 丰 丰 心
讀	言 士 罒 貝
讁	言 亠 丷 辶
讂	言 冖 冂 夊
讃	言 夫 夫 貝
讄	言 田 田 田
讅	言 宀 丿 田
讆	彳 韋 亍 言
讇	言 門 冖 臼
讈	言 厂 禾 止
讉	言 口 丄 辶
變	言 糹 糹 夊
讋	立 月 {龍右} 言
讌	言 卄 一 灬
讍	言 王 口 口
讎	隹 言 隹
讏	彳 {五下} 口 言
讐	隹 隹 言
讑	言 合 口 冊
讒	言 冖 口 丶
讓	言 {京頭} 口 𧘇
讔	言 阝 爪 心
讕	言 門 木 丷
讖	言 人 人 一
讗	言 山 隹 口
讘	言 耳 耳 耳
讙	言 艹 口 隹
讚	言 ⺧ 儿 貝
讛	言 艹 土 厶
讜	言 尚 黑
讝	言 口 口 夊
讞	言 {虎头} 一 犬
讟	言 士 罒 言
讬	讠 丿 七
讱	讠 刀 丶
讻	讠 乂 凵
诇	讠 冂 口
诐	讠 皮
诪	讠 丰 寸
谉	讠 宀 申
谞	讠 乛 龰 月
谸	千 八 人 口
谹	八 人 口 厶
谺	八 人 口 牙
谻	八 人 口 キ
谼	八 人 口 八
谽	八 人 口 口
谾	八 人 口 工
谿	爪 幺 大 口
豀	八 人 口 大
豂	八 人 口 彡
豃	八 人 口 夊
豄	八 人 口 貝
豅	八 人 口 {龍右}
豈	山 一 口 䒑
豊	冂 龷 一 䒑
豋	{祭上} 一 口 䒑
豍	一 口 䒑 十
豎	臣 又 一 䒑
豏	一 口 䒑 八
豐	山 丰 丰 䒑
豑	冂 龷 一 丿
豒	山 丰 丰 丿
豓	山 丰 丰 皿
豔	山 丰 丰 皿
豖	豕 丶
豗	兀 豕
豘	豕 七 凵
豙	立 豕
豛	豕 殳
豜	豕 一 卄
豝	豕 巴
豞	豕 勹 口
豟	豕 户 乙
豠	豕 且
豣	豕 干 干
豤	豕 艮
豥	豕 亥
豦	{虎头} 豕
豧	豕 甫
豨	豕 乂 {左上} 巾
豩	豕 豕
豬	豕 耂 日
豭	豕 尸 二 又
豮	豕 十 卄 贝
豯	豕 爪 幺 大
豰	{穀頭} 一 豕
豱	豕 日 皿
豲	豕 厂 白 小
豴	豕 亠 丷 古
豵	豕 彳 人 龰
豶	豕 十 卄 貝
豷	豕 士 冖 䒑
豻	豸 干
豼	豸 匕 匕
豽	豸 冂 人
豾	豸 不 一
豿	豸 勹 口
貀	豸 屮 凵
貁	豸 穴
貃	豸 白
貄	豸 彐 キ
貆	豸 一 日 一
貇	豸 艮
貈	豸 舟
貋	豸 日 干
貍	豸 里
貎	豸 臼 儿
貏	豸 {卑上} 十
貐	豸 人 一 刂
貑	豸 尸 二 又
貒	豸 山 而
貓	豸 艹 田
貕	豸 爪 幺 大
貖	豸 䒑 八 皿
貗	豸 口 十 女
貙	豸 匚 口 口
貚	豸 口 口 十
貛	豸 艹 口 隹
貜	豸 目 目 又
貝	貝
貞	卜 貝
貟	厶 貝
負	冖 貝
財	貝 {于下} 丿
貢	工 貝
貣	弋 貝
貤	貝 也
貥	貝 亠 几
貦	貝 一 兀
貧	八 刀 貝
貨	亻 匕 貝
販	貝 ⺁ 又
貪	人 丶 乛 貝
貫	{母框} 十 貝
責	龶 貝
貭	⺁ 十 貝
貮	一 弋 貝
貯	貝 宀 丁
貰	世 貝
貱	貝 皮
貲	止 匕 貝
貳	弋 二 貝
貴	口 丄 貝
貵	厶 大 貝
貶	貝 丿 之
買	罒 貝
貸	亻 弋 貝
貹	貝 生
貺	貝 口 儿
費	弓 {介下} 貝
貼	貝 卜 口
貽	貝 厶 口
貾	貝 {卬左} 七 丶
貿	卯 貝
賀	力 口 貝
賁	十 卄 貝
賂	貝 夊 口
賃	亻 壬 貝
賄	貝 {左上} 月
賅	貝 亥
賆	貝 䒑 卄
資	二 欠 貝
賈	西 貝
賉	貝 丿 皿
賊	貝 戈 {左上}
賋	貝 亠 八 乂
賌	亥 貝
賍	貝 广 土
賎	貝 二 戈
賏	貝 貝
賐	貝 厶 八 夊
賑	貝 辰
賒	貝 人 示
賓	宀 一 小 貝
賔	宀 {眉上} 貝
賕	貝 一 水 丶
賖	貝 人 一 木
賗	貝 口 口 丨
賘	貝 广 土 丶
賙	貝 ⺆ 土 口
賚	來 貝
賛	夫 夫 貝
賜	貝 日 勹 {两撇}
賝	貝 冖 八 木
賞	尚 貝
賟	貝 冂 龷 八
賠	貝 立 口
賡	广 彐 人 貝
賢	臣 又 貝
賣	士 罒 貝
賤	貝 戈 戈
賥	貝 亠 人 十
賦	貝 一 弋 止
賧	貝 火 火
賨	宀 示 貝
賩	貝 宀 示
質	斤 斤 貝
賫	十 人 人 貝
賬	貝 長
賭	貝 耂 日
賮	肀 一 灬 貝
賯	貝 勹 日 子
賰	貝 𡗗 日
賱	貝 冖 車
賲	亻 口 木 貝
賳	貝 十 戈 口
賴	木 口 冖 貝
賵	貝 冂 二 目
賶	貝 人 丶 口
賷	十 口 口 貝
賸	月 丷 夫 貝
賹	貝 䒑 八 皿
賺	貝 䒑 彐 八
賻	貝 甫 寸
購	貝 {冓上} 冂 土
賽	宀 {冓上} 八 貝
賾	臣 龶 貝
賿	貝 习 习 彡
贀	匚 矢 殳 貝
贁	貝 貝 夊
贂	貝 厶 厶 彡
贃	貝 口 口 心
贄	土 䒑 十 貝
贅	龶 勹 夊 貝
贆	貝 犬 犬 犬
贇	文 一 弋 貝
贈	貝 丷 日 日
贉	貝 西 早
贊	⺧ 儿 ⺧ 貝
贋	厂 亻 隹 貝
贌	貝 业 䒑 夫
贍	貝 冖 厂 言
贎	貝 艹 禺
贏	{贏頭} 貝
贐	貝 肀 一 皿
贑	立 早 工 貝
贒	臣 口 丨 貝
贓	貝 戈 爿 臣
贔	貝 貝 貝
贕	卯 丶 丶 貝
贖	貝 士 罒 貝
贗	厂 亻 鳥 貝
贘	貝 尚 貝
贙	虎 虎 貝
贚	貝 立 月 {龍右}
贛	立 早 夊 貝
贜	貝 艹 戈 臣
贠	厶 贝
赑	贝 贝 贝
赒	贝 ⺆ 土 口
赗	贝 冂 二 目
赟	文 一 弋 贝
赥	土 {介下} 八 欠
赨	土 {介下} 八 虫
赩	土 {介下} 八 巴
赪	土 {介下} 八 贝
赬	土 {介下} 八 貝
赮	土 {介下} 八 又
赯	土 {介下} 八 口
赱	土 丷 乀
赲	走 力
赸	走 山
赹	走 勹 二
赺	走 人 丶 乛
赻	走 小 丿
赼	走 欠
赽	走 コ 人
赾	走 斤
赿	走 {卬左} 七
趀	走 丿 ㇉ 丿
趂	走 冖 小
趃	走 丿 夫
趆	走 {卬左} 七 丶
趇	走 立
趈	走 卜 口
趉	走 屮 凵
趌	走 士 口
趍	走 夕 夕
趎	走 牛 八
趏	走 舌
趐	走 习 习
趒	走 儿 二 二
趓	走 几 木
趕	走 日 干
趖	走 人 人 土
趗	走 足
趘	走 尸 毛
趙	走 小 月
趚	走 木 口
趛	走 金
趜	走 勹 米
趝	走 人 丶 心
趞	走 龷 日
趠	走 卜 早
趡	走 隹
趢	走 彐 水
趤	走 宀 石
趥	走 丷 酉
趦	走 二 欠 口
趧	走 日 一 龰
趨	走 勹 屮 屮
趩	走 田 龷 八
趪	走 龷 由 八
趫	走 夭 口 口
趬	走 土 土 兀
趭	走 隹 灬
趮	走 口 口 木
趯	走 习 习 隹
趰	走 一 八 乂
趲	走 ⺧ 儿 貝
趶	足 一 {于下}
趷	足 𠂉 乙
趹	足 コ 人
趻	足 人 丶 乛
趽	足 方
跀	足 月
跁	足 巴
跂	足 十 又
跅	足 斤 丶
跇	足 世
跈	足 人 彡
跉	足 人 丶 マ
跊	足 未
跍	足 古
跐	足 止 匕
跒	足 丁 口
跓	足 丶 王
跔	足 勹 口
跕	足 卜 口
跘	足 丷 キ
跙	足 且
跜	足 尸 匕
跠	足 大 弓
跡	足 亦
跢	足 夕 夕
跥	足 乃 木
跦	足 牛 八
跧	足 人 王
跩	足 电 丿
跭	足 夊 ヰ
跮	足 至
跰	足 䒑 卄
跱	足 土 寸
跲	足 合
跴	足 西
跶	足 大 辶
跼	足 尸 乛 口
跾	亻 丨 夊 足
跿	足 走
踀	足 足
踁	足 一 巛 工
踂	足 耳 乚
踃	足 小 月
踄	足 止 小
踆	足 厶 八 夊
踇	足 𠂉 母
踈	足 木 口
踋	足 土 厶 卩
踍	足 耂 子
踎	足 不 口
踐	足 戈 戈
踑	足 其
踒	足 禾 女
踓	足 隹
踕	足 一 彐 龰
踖	足 龷 日
踗	足 人 丶 心
踘	足 勹 米
踙	足 耳 又
踚	足 人 一 冊
踛	足 土 八 土
踜	足 土 八 夊
踠	足 宀 夕 㔾
踡	足 丷 夫 㔾
踤	足 亠 人 十
踥	足 立 女
踦	足 大 丁 口
踧	足 上 小 又
踨	足 人 人 龰
踫	足 䒑 业
踭	足 冖 彐 亅
踰	足 人 一 刂
踲	足 ⺁ 十 目
踳	足 𡗗 日
踴	足 マ 用 力
踶	足 日 一 龰
踷	足 耂 日
踸	足 其 乚
踻	足 咼
踼	足 日 一 {两撇}
踾	足 一 口 田
踿	足 禾 火
蹃	足 艹 {左上} 口
蹅	足 木 日 一
蹆	足 艮 辶
蹌	足 人 丶 口
蹍	足 尸 艹 {畏下}
蹎	足 十 且 八
蹏	足 ⺁ 虎
蹐	足 二 二 月
蹓	足 卯 田
蹔	車 斤 足
蹕	足 日 卄 キ
蹖	足 𡗗 臼
蹗	足 鹿
蹘	足 习 习 彡
蹚	足 尚 土
蹛	足 卌 一 巾
蹜	足 宀 亻 日
蹝	足 彳 止 龰
蹞	足 匕 丆 貝
蹟	足 龶 貝
蹠	足 广 卄 灬
蹡	足 爿 月 寸
蹢	足 亠 丷 古
蹣	足 卄 一 入
蹤	足 彳 人 龰
蹥	足 車 辶
蹧	足 艹 日 日
蹨	足 月 犬 灬
蹪	足 口 丄 貝
蹫	足 予 丿 口
蹮	足 西 大 巳
蹱	足 立 里
蹳	足 癶 弓 殳
蹵	{京頭} 小 尤 足
蹷	厂 䒑 屮 足
蹸	足 米 夕 ヰ
蹹	足 合 习 习
蹺	足 土 土 兀
蹻	足 夭 口 口
蹽	足 大 丷 小
蹾	足 {京頭} 子 夊
躀	足 {母框} 十 貝
躂	足 土 羊 辶
躃	足 尸 口 辛
躄	尸 口 辛 足
躆	足 {虎头} 豕
躈	足 白 方 夊
躉	艹 禺 足
躊	足 士 乛 寸
躋	足 亠 丷 二
躌	足 𠂉 卅 ヰ
躍	足 习 习 隹
躎	足 一 八 乂
躑	足 丷 酉 阝
躒	足 白 幺 木
躓	足 斤 斤 貝
躕	足 广 士 寸
躖	足 幺 幺 一
躗	彳 韋 亍 足
躘	足 立 月 {龍右}
躙	足 門 隹
躚	足 西 大 辶
躛	彳 {五下} 口 足
躝	足 門 木 丷
躟	足 {京頭} 口 𧘇
躠	艹 𠂤 辛 足
躡	足 耳 耳 耳
躢	足 門 日 习
躣	足 目 目 隹
躤	足 艹 丰 日
躥	足 穴 臼 {鼠下}
躦	足 ⺧ 儿 貝
躧	足 一 {冂丶} 鹿
躨	足 䒑 自 夊
躩	足 目 目 又
躪	足 艹 門 隹
躭	身 冖 儿
躮	身 八 刀
躰	身 木 一
躱	身 乃 木
躳	身 口 口
躴	身 丶 艮
躵	身 刀 丶 心
躶	身 日 木
躷	身 禾 女
躸	身 大 丁 口
躹	身 勹 米
躻	身 穴 工
躼	身 長
躽	身 匚 日 女
躾	身 羊 大
躿	身 广 彐 水
軀	身 匚 口 口
軁	身 口 十 女
軂	身 火 火 力
軃	身 口 口 十
軄	身 立 日 戈
軅	身 厂 亻 隹
軆	身 冂 龷 䒑
軇	身 士 乛 寸
軈	身 广 亻 心
軉	身 宀 王 貝
車	車
軋	車 乚
軌	車 九
軍	冖 車
軏	車 兀
軐	車 乛 十
軑	車 大
軒	車 干
軓	車 几 丶
軔	車 刀 丶
軕	車 山
軖	車 王
軗	車 殳
軘	車 七 凵
軙	車 卜 又
軚	車 大 丶
軛	車 厂 㔾
軜	車 冂 人
軝	車 {卬左} 七
軞	車 毛
軟	車 欠
軠	車 壬
軡	車 人 丶 乛
転	車 二 厶
軣	車 二 二
軤	車 丿 丷 {于下}
軥	車 勹 口
軦	車 口 儿
軧	車 {卬左} 七 丶
軨	車 人 丶 マ
軩	車 厶 口
軪	車 幺 力
軫	車 人 彡
軬	厶 大 車
軭	車 匚 王
軮	車 冂 大
軯	車 干 丷
軰	丬 匕 車
軱	車 瓜
軲	車 古
軳	車 勹 巳
軴	車 丶 王
軵	車 亻 寸
軶	車 户 乙
軷	車 {左上} 又 丶
軸	車 由
軹	車 口 八
軺	車 刀 口
軻	車 丁 口
軼	車 丿 夫
軽	車 又 土
軾	車 弋 工
軿	車 䒑 卄
輀	車 而
輁	車 龷 八
輂	龷 八 車
較	車 亠 八 乂
輄	車 小 兀
輅	車 夊 口
輆	車 亥
輇	車 人 王
輈	車 舟
載	十 戈 車
輊	車 至
輋	山 大 車
輌	車 一 冂 山
輍	車 八 人 口
輎	車 小 月
輏	車 酉
輐	車 宀 一 兀
輑	車 彐 丿 口
輒	車 耳 乚
輓	車 冖 口 儿
輔	車 甫
輕	車 一 巛 工
輖	車 ⺆ 土 口
輗	車 臼 儿
輘	車 土 八 夊
輙	車 耳 又
輚	車 戈 戈
輛	車 一 巾 入
輜	車 巛 田
輝	小 兀 冖 車
輞	車 冂 䒑 亡
輟	車 又 又 又
輠	車 日 木
輡	車 冖 臼
輢	車 大 丁 口
輣	車 月 月
輤	車 龶 月
輥	車 日 匕 匕
輦	夫 夫 車
輧	車 丿 干 干
輨	車 宀 尸 コ
輩	非 車
輪	車 人 一 冊
輫	車 非
輬	車 {京頭} 小
輭	車 而 大
輮	車 予 丿 木
輯	車 口 耳
輰	車 日 一 {两撇}
輱	車 戊 一 口
輲	車 山 而
輳	車 𡗗 一 大
輴	車 ⺁ 十 目
輵	車 日 勹 乚
輶	車 丷 酉
輷	車 勹 言
輸	車 人 一 刂
輹	車 𠂉 日 夊
輺	車 巛 一 田
輻	車 一 口 田
輼	車 日 皿
輽	車 厶 大 田
輾	車 尸 艹 {畏下}
輿	臼 車 一 八
轀	車 囗 人 皿
轁	車 爪 臼
轂	{穀頭} 一 車
轃	車 𡗗 禾
轄	車 宀 丰 口
轅	車 土 口 𧘇
轆	車 鹿
轇	車 习 习 彡
轈	車 巛 日 木
轉	車 {專上} 寸
轊	車 丰 丰 彐
轋	車 車 辶
轌	車 雨 彐
轍	車 亠 厶 夊
轎	車 夭 口 口
轏	車 尸 子 子
轐	車 业 䒑 夫
轑	車 大 丷 小
轒	車 十 卄 貝
轓	車 丿 米 田
轔	車 米 夕 ヰ
轕	車 艹 日 乚
轖	車 土 人 口
轗	車 戊 一 心
轘	車 罒 一 𧘇
轙	車 羊 丿 戈
轚	車 凵 殳 車
轛	車 业 羊 寸
轜	車 雨 而
轝	臼 丂 丄 車
轞	車 臣 {⺮右} 皿
轟	車 車 車
轠	車 田 田 田
轡	糹 車 糸 口
轢	車 白 幺 木
轣	車 厂 禾 止
轤	車 {虎头} 田 皿
轥	車 艹 門 隹
轪	车 大
辀	车 舟
辌	车 {京頭} 小
辒	车 日 皿
辝	厶 口 辛
辠	自 辛
辡	辛 辛
辢	木 口 辛
辤	爪 冖 又 辛
辥	屮 𠂤 辛
辦	辛 力 辛
辧	辛 刀 辛
辪	止 𠂤 辛
辬	辛 文 辛
辭	爪 マ 冂 辛
辮	辛 糸 辛
辯	辛 言 辛
農	冂 龷 辰
辳	木 木 辰
辴	口 口 日 辰
辵	彡 龰
辷	一 辶
辸	乃 辶
辺	刀 辶
辻	十 辶
込	入 辶
辿	山 辶
迀	干 辶
迃	一 丂 辶
迆	也 辶
迉	尸 辶
迊	一 巾 辶
迋	王 辶
迌	月 辶
迍	七 凵 辶
迏	大 丶 辶
迒	亠 几 辶
迖	犬 辶
迗	一 大 辶
迚	口 丨 辶
迠	卜 口 辶
迡	尸 匕 辶
迣	世 辶
迧	申 辶
迬	丶 王 辶
迯	夕 卜 辶
迱	宀 匕 辶
迲	土 厶 辶
迴	囗 口 辶
迵	冂 一 口 辶
迶	{左上} 月 辶
迺	西 辶
迻	夕 夕 辶
迼	士 口 辶
迾	一 夕 刂 辶
迿	勹 日 辶
逇	土 也 辶
逈	向 辶
逌	卜 囗 コ 辶
逎	酉 辶
逓	⺁ 二 巾 辶
逕	一 巛 工 辶
逘	厶 矢 辶
這	言 辶
逜	一 {五下} 口 辶
連	車 辶
逤	氵 小 丿 辶
逥	囗 〢 二 辶
逧	八 人 口 辶
逨	來 辶
逩	大 十 卄 辶
逪	龷 日 辶
逫	又 又 又 辶
逬	丿 干 丿 辶
逰	扌 𠂉 子 辶
週	⺆ 土 口 辶
進	隹 辶
逳	亠 厶 月 辶
逴	卜 早 辶
逷	日 勹 {两撇} 辶
逹	土 䒑 十 辶
逺	土 乚 𧘇 辶
逽	艹 {左上} 口 辶
逿	日 一 勹 辶
遀	{左上} 工 月 辶
遃	立 丿 彡 辶
遅	尸 羊 辶
遆	亠 丷 冖 辶
遈	日 一 龰 辶
遉	卜 貝 辶
遊	方 𠂉 子 辶
運	冖 車 辶
遌	口 口 一 辶
過	咼 辶
達	土 羊 辶
違	韋 辶
遖	十 冂 䒑 辶
遙	月 缶 辶
遚	臼 丨 又 辶
遜	子 丿 糸 辶
遝	罒 水 辶
遞	⺁ 虎 辶
遟	尸 辛 辶
遠	土 口 𧘇 辶
遡	䒑 屮 月 辶
遤	馬 辶
遦	{母框} 十 貝 辶
遧	立 早 辶
適	亠 丷 冂 辶
遪	厶 厶 厶 辶
遫	木 口 夊 辶
遬	木 口 欠 辶
遯	月 豕 辶
遰	卌 一 冖 辶
遱	口 十 口 辶
遲	尸 水 牛 辶
遳	艹 人 人 辶
遶	土 土 土 辶
遷	西 大 巳 辶
選	巳 巳 龷 辶
遹	予 丿 冂 辶
遺	口 丄 貝 辶
遻	口 口 䒑 辶
遼	大 丷 日 辶
遾	竹 工 人 辶
邁	艹 禺 辶
還	罒 一 口 辶
邅	亠 囗 口 辶
邆	癶 一 口 辶
邇	一 八 巾 辶
邉	自 穴 口 辶
邊	自 穴 方 辶
邌	禾 勹 丿 辶
邍	夊 田 彐 辶
邎	月 言 丿 辶
邏	罒 糹 隹 辶
邐	一 {冂丶} 一 辶
邒	丁 阝
邔	己 阝
邖	山 阝
邘	一 {于下} 阝
邚	女 阝
邜	夕 阝
邞	夫 阝
邟	亠 几 阝
邠	八 刀 阝
邤	斤 阝
邥	冖 儿 阝
邧	一 兀 阝
邨	七 凵 阝
邩	火 阝
邫	丰 口 巴
邭	勹 口 阝
邲	心 丿 阝
邷	瓦 阝
邼	匚 王 阝
邽	土 土 阝
邿	土 寸 阝
郀	大 一 丂 阝
郂	亥 阝
郃	合 阝
郆	士 口 阝
郈	⺁ 一 口 阝
郉	干 干 阝
郋	自 阝
郌	土 土 口 巴
郍	舟 阝
郒	丶 彐 厶 巴
郔	丿 止 廴 阝
郕	戊 乛 阝
郖	一 口 䒑 阝
郘	口 口 阝
郙	甫 阝
郚	一 {五下} 口 阝
郞	丶 艮 阝
郟	大 人 人 阝
郠	一 日 乂 阝
郣	十 冖 子 阝
郤	八 人 口 阝
郥	貝 阝
郩	乂 {左上} 月 阝
郪	十 彐 女 阝
郬	龶 月 阝
郮	⺆ 土 口 阝
郰	耳 又 阝
郱	䒑 卄 阝
郲	來 阝
郳	臼 儿 阝
郵	壬 龷 阝
郶	立 口 口 巴
郷	{纟上} 丿 彐 阝
郹	目 犬 阝
郺	夕 夕 巛 巴
郻	目 乚 巛 阝
郼	韋 阝
郿	{眉上} 目 阝
鄀	艹 {左上} 口 阝
鄁	丬 匕 月 阝
鄃	人 一 月 阝
鄅	丿 虫 冂 阝
鄆	冖 車 阝
鄇	亻 コ 矢 阝
鄈	癶 一 大 阝
鄉	{纟上} 丿 丶 阝
鄊	{纟上} 丿 耳 阝
鄋	臼 丨 又 阝
鄌	广 肀 口 阝
鄍	冖 日 亠 阝
鄎	自 心 阝
鄏	辰 寸 阝
鄐	亠 幺 田 阝
鄑	丌 䒑 日 阝
鄒	勹 屮 勹 阝
鄓	自 犬 阝
鄔	烏 阝
鄕	{纟上} 丿 白 阝
鄖	口 貝 阝
鄗	高 阝
鄘	广 肀 月 阝
鄚	艹 日 大 阝
鄛	巛 日 木 阝
鄜	鹿 阝
鄝	习 习 人 阝
鄟	{專上} 寸 阝
鄠	雨 一 丂 阝
鄡	{鳥上} 木 阝
鄤	日 罒 又 阝
鄥	鳥 阝
鄦	𠂉 卌 一 阝
鄧	癶 一 口 阝
鄨	丷 巾 八 巴
鄩	彐 工 口 阝
鄪	弓 {介下} 貝 阝
鄫	丷 日 丷 阝
鄬	爪 {爲下} 阝
鄭	丷 酉 大 阝
鄮	卯 貝 阝
鄰	米 夕 ヰ 阝
鄲	口 口 日 阝
鄳	黽 阝
鄴	业 羊 八 阝
鄵	口 口 口 阝
鄶	人 一 日 阝
鄷	冂 龷 一 阝
鄸	艹 罒 冖 阝
鄺	广 龷 由 阝
鄻	夫 夫 車 阝
鄼	夫 夫 貝 阝
鄽	广 里 八 阝
鄾	丆 月 冖 阝
鄿	艹 口 口 阝
酀	卄 一 口 阝
酁	冖 口 匕 阝
酂	⺧ 儿 ⺧ 阝
酄	艹 口 口 阝
酅	山 隹 冂 阝
酇	⺧ 儿 ⺧ 阝
酈	一 {冂丶} 一 阝
酑	酉 一 {于下}
酓	人 丶 乛 酉
酔	酉 九 十
酕	酉 毛
酖	酉 冖 儿
酘	酉 殳
酙	酉 ⺀ 十
酛	酉 一 兀
酜	酉 夫
酟	酉 卜 口
酠	酉 丁 口
酦	酉 丩 又 丶
酧	酉 宀 寸
酨	十 戈 酉
酫	酉 人 王
酭	酉 {左上} 月
酳	酉 幺 月
酺	酉 甫
酻	酉 爪 子
酼	酉 亠 厶 {荒下}
醀	酉 隹
醁	酉 彐 水
醂	酉 木 木
醃	酉 大 电
醄	酉 勹 缶
醆	酉 戈 戈
醈	酉 火 火
醊	酉 又 又 又
醎	酉 戊 一 口
醏	酉 耂 日
醓	酉 冖 儿 皿
醔	禾 火 酉
醕	酉 {京頭} 日
醖	酉 日 皿
醗	酉 癶 二 儿
醘	酉 土 厶 皿
醙	酉 臼 丨 又
醜	酉 鬼
醝	酉 羊 工
醞	酉 囗 人 皿
醟	火 火 冖 酉
醠	酉 冂 大 皿
醡	酉 穴 𠂉 {乍下}
醤	丬 爪 寸 酉
醥	酉 西 示
醦	酉 厶 厶 彡
醧	酉 匚 口 口
醨	酉 文 凵 厶
醩	酉 艹 日 日
醫	匚 矢 殳 酉
醬	爿 月 寸 酉
醰	酉 西 早
醱	酉 癶 弓 殳
醲	酉 冂 龷 辰
醳	酉 罒 土 十
醶	酉 僉
醷	酉 立 日 心
醸	酉 亠 八 𧘇
醹	酉 雨 而
醻	酉 士 乛 寸
醼	酉 卄 一 灬
醽	酉 雨 口 口
醾	酉 麻 米
醿	酉 麻 糸
釀	酉 {京頭} 口 𧘇
釁	臼 冂 一 刀
釂	酉 爪 罒 寸
釃	酉 一 {冂丶} 鹿
釄	酉 麻 非
釅	酉 口 口 夊
釆	丿 米
釈	丿 米 尸 乀
釋	丿 米 罒 十
釐	未 夊 厂 里
釒	金
釓	金 乚
釔	金 乙
釕	金 了
釖	金 刀
釗	金 刂
釘	金 丁
釙	金 卜
釚	金 九
釛	金 力
針	金 十
釞	金 入
釟	金 八
釠	金 几
釡	八 金
釢	金 乃
釣	金 勹 丶
釤	金 彡
釥	金 小
釦	金 口
釧	金 川
釨	金 子
釩	金 几 丶
釪	金 一 {于下}
釫	金 一 丂
釬	金 干
釭	金 工
釮	金 {于下} 丿
釯	金 亡
釰	金 刀 丶
釱	金 大
釲	金 巳
釳	金 𠂉 乙
釴	金 弋
釵	金 又 丶
釶	金 也
釷	金 土
釸	金 夕
釹	金 女
釺	金 千
釻	金 九 丶
釼	金 刀 乀
釽	金 爪
釾	金 牙
釿	金 斤
鈀	金 巴
鈁	金 方
鈂	金 冖 儿
鈃	金 一 卄
鈄	金 ⺀ 十
鈅	金 月
鈆	金 八 厶
鈇	金 夫
鈈	金 不
鈉	金 冂 人
鈊	金 心
鈋	金 亻 匕
鈌	金 コ 人
鈍	金 七 凵
鈎	金 勹 厶
鈏	金 弓 丨
鈐	金 人 丶 乛
鈑	金 ⺁ 又
鈒	金 乃 乀
鈓	金 壬
鈔	金 小 丿
鈕	金 丑
鈖	金 八 刀
鈗	金 厶 儿
鈘	金 十 又
鈙	金 卜 又
鈚	金 匕 匕
鈛	金 戈
鈜	金 {左上} 厶
鈝	金 牛
鈞	金 勹 二
鈟	金 弓 丨
鈠	金 殳
鈡	金 口 丨
鈢	金 木
鈣	金 丅 一 ㇉
鈤	金 日
鈥	金 火
鈦	金 大 丶
鈧	金 亠 几
鈨	金 一 兀
鈩	金 户
鈪	金 厂 㔾
鈫	金 文
鈬	金 尸 乀
鈭	止 匕 金
鈮	金 尸 匕
鈯	金 屮 凵
鈰	金 亠 巾
鈱	金 巳 七
鈲	金 瓜
鈳	金 丁 口
鈴	金 人 丶 マ
鈵	金 一 冂 人
鈶	金 厶 口
鈷	金 古
鈸	金 {左上} 又 丶
鈹	金 皮
鈺	金 王 丶
鈻	金 尸 コ
鈼	金 𠂉 {乍下}
鈽	金 {左上} 巾
鈾	金 由
鈿	金 田
鉀	金 甲
鉁	金 人 彡
鉂	金 口 乂
鉃	金 矢
鉄	金 丿 夫
鉅	金 匚 コ
鉆	金 卜 口
鉇	金 𠂉 也
鉈	金 宀 匕
鉉	金 亠 幺
鉊	金 刀 口
鉋	金 勹 巳
鉌	金 禾
鉍	金 心 丿
鉎	金 生
鉏	金 且
鉐	金 石
鉑	金 白
鉒	金 丶 王
鉓	金 𠂉 巾
鉔	金 匚 巾
鉕	金 匚 口
鉖	金 夊 ⺀
鉗	金 卄 二
鉘	金 弓 {介下}
鉙	金 口 八
鉚	金 卯
鉛	金 几 口
鉜	金 亻 寸
鉝	金 立
鉞	金 戈 乚
鉟	金 不 一
鉠	金 冂 大
鉡	金 丷 キ
鉢	金 木 一
鉣	金 土 厶
鉤	金 勹 口
鉥	金 木 丶
鉦	金 一 止
鉧	金 母
鉨	金 冖 小
鉩	金 人 小
鉪	金 世
鉫	金 力 口
鉬	金 目
鉭	金 日 一
鉮	金 申
鉯	金 乚 丶 人
鉰	金 乛 一 口
鉱	金 广 厶
鉲	金 上 卜
鉳	金 丬 匕
鉵	金 虫
鉶	金 一 卄 刂
鉷	金 龷 八
鉸	金 亠 八 乂
鉹	金 夕 夕
鉺	金 耳
鉻	金 夊 口
鉼	金 䒑 卄
鉽	金 弋 工
鉾	金 厶 牛
鉿	金 合
銀	金 艮
銁	金 勹 日
銂	金 ⺍ 川
銃	金 亠 厶 儿
銄	金 向
銅	金 冂 一 口
銆	金 丆 日
銇	金 丰 八
銈	金 土 土
銉	金 彐 キ
銊	金 戊 一
銋	金 亻 壬
銌	金 {左上} 丨 子
銍	金 至
銏	金 ⺆ ⺆ 一
銐	一 夕 刂 金
銑	金 ⺧ 儿
銒	金 干 干
銓	金 人 王
銔	金 不 十
銕	金 大 弓
銖	金 牛 八
銗	金 ⺁ 一 口
銘	金 夕 口
銙	金 大 一 丂
銚	金 儿 二 二
銛	金 舌
銜	彳 金 亍
銝	金 亻 木
銞	勹 日 金
銟	金 山 巾
銠	金 耂 匕
銡	金 士 口
銢	金 二 水
銣	金 女 口
銤	金 米
銥	金 亠 𧘇
銦	金 囗 大
銧	金 小 兀
銨	金 宀 女
銩	金 壬 厶
銪	金 {左上} 月
銫	金 冖 巴
銬	金 耂 丂
銭	金 二 戈
銯	金 糸
銰	金 艹 乂
銱	金 口 巾
銲	金 日 干
銳	金 八 口 儿
銴	扌 斤 金
銵	金 身
銶	金 一 水 丶
銷	金 小 月
銸	金 耳 乚
銹	金 禾 乃
銺	爿 士 金
銻	金 丷 弓 丿
銼	金 人 人 土
銽	金 {卬左} 七 口
銾	金 工 水
銿	金 マ 用
鋀	金 一 口 䒑
鋁	金 口 口
鋂	金 𠂉 母
鋃	金 丶 艮
鋄	金 一 火 又
鋅	金 辛
鋆	土 勹 二 金
鋇	金 貝
鋉	金 木 口
鋊	金 八 人 口
鋋	金 丿 止 廴
鋌	金 壬 廴
鋍	金 十 冖 子
鋎	金 宀 一 兀
鋏	金 大 人 人
鋐	金 宀 {左上} 厶
鋑	金 厶 八 夊
鋒	金 夊 丰
鋓	金 禾 刂
鋔	金 冖 口 儿
鋕	金 士 心
鋖	金 爪 女
鋗	金 口 月
鋘	金 口 一 大
鋙	金 一 {五下} 口
鋚	亻 丨 夊 金
鋛	金 口 口 丨
鋜	金 足
鋝	金 爪 寸
鋞	金 一 巛 工
鋟	金 彐 冖 又
鋠	金 辰
鋡	金 人 丶 口
鋢	金 爪 子
鋣	金 牙 阝
鋤	金 且 力
鋥	金 口 王
鋦	金 尸 乛 口
鋧	金 見
鋨	金 丿 扌 戈
鋩	金 艹 亡
鋪	金 甫
鋫	禾 刂 金
鋬	扌 ⺁ 又 金
鋭	金 丷 口 儿
鋮	金 戊 乛
鋯	金 ⺧ 口
鋰	金 里
鋱	金 弋 心
鋲	金 斤 一 八
鋳	金 丰 寸
鋴	金 古 儿
鋵	金 禾 几
鋶	金 亠 厶 {荒下}
鋷	金 耳 又
鋸	金 尸 古
鋹	金 長
鋺	金 宀 夕 㔾
鋻	臣 又 金
鋼	金 冂 䒑 山
鋽	金 卜 早
鋾	金 勹 缶
鋿	金 尚
錀	金 人 一 冊
錁	金 日 木
錂	金 土 八 夊
錃	氵 皮 金
錄	金 彑 水
錅	禾 勹 丿 金
錆	金 龶 月
錇	金 立 口
錈	金 丷 夫 㔾
錉	金 {卬左} 七 日
錊	金 亠 人 十
錋	金 月 月
錌	金 山 厂 干
錍	金 {卑上} 十
錎	金 冖 臼
錏	金 一 {亞下}
錐	金 隹
錑	金 户 犬
錒	金 阝 丁 口
錓	金 羊 乚
錔	金 水 日
錕	金 日 匕 匕
錖	上 小 又 金
錗	金 禾 女
錘	金 壬 龷
錙	金 巛 田
錚	金 冖 彐 亅
錛	金 大 十 卄
錜	金 人 丶 心
錝	金 宀 示
錞	金 {京頭} 子
錟	金 火 火
錠	金 宀 一 龰
錡	金 大 丁 口
錢	金 戈 戈
錣	金 又 又 又
錤	金 其
錥	金 亠 厶 月
錦	金 白 巾
錧	金 宀 尸 コ
錨	金 艹 田
錩	金 日 日
錪	金 冂 龷 八
錫	金 日 勹 {两撇}
錬	金 木 日
錭	金 ⺆ 土 口
錮	金 囗 古
錯	金 龷 日
錰	金 木 灬
錱	金 王 王
録	金 彐 水
錳	金 子 皿
錴	金 土 八 土
錵	金 艹 亻 匕
錶	金 龶 𧘇
錷	金 車 乚
錸	金 來
錹	金 止 月
錺	金 艹 方
錻	金 一 弋 止
錼	金 大 示
錽	金 一 火 夊
錿	金 虎
鍀	金 日 一 寸
鍁	金 斤 欠
鍂	金 金
鍃	金 勹 {两撇} 心
鍄	金 {京頭} 小
鍅	金 氵 土 厶
鍆	金 門
鍇	金 匕 匕 白
鍈	金 艹 冂 大
鍉	金 日 一 龰
鍊	金 木 囗 丷
鍋	金 咼
鍌	氵 ⺧ 儿 金
鍍	金 广 卄 又
鍎	金 ⺁ 十 目
鍏	金 韋
鍐	金 乂 凵 夊
鍑	金 𠂉 日 夊
鍒	金 予 丿 木
鍓	金 口 耳
鍔	金 口 口 丂
鍕	金 冖 車
鍖	金 其 乚
鍗	金 亠 丷 巾
鍘	金 貝 刂
鍙	氵 龷 八 金
鍚	金 日 一 {两撇}
鍛	金 亻 三 殳
鍜	金 尸 二 又
鍝	金 禺
鍞	金 卜 貝
鍟	金 日 生
鍠	金 白 王
鍡	金 田 {畏下}
鍢	金 一 口 田
鍣	金 艹 刀 口
鍤	金 千 臼
鍥	金 丰 刀 大
鍦	金 方 𠂉 也
鍧	金 勹 言
鍨	金 癶 一 大
鍩	金 艹 {左上} 口
鍫	禾 火 金
鍬	金 禾 火
鍭	金 亻 コ 矢
鍮	金 人 一 刂
鍯	金 勹 {两撇} 心
鍰	金 爪 干 又
鍱	金 世 木
鍲	金 巳 七 日
鍳	臣 {⺮右} 金
鍴	金 山 而
鍵	金 彐 キ 廴
鍶	金 田 心
鍷	金 大 土 土
鍸	金 古 月
鍹	金 宀 一 一
鍺	金 耂 日
鍻	金 日 勹 乚
鍼	金 戊 一 口
鍽	金 户 冊
鍿	金 巛 一 田
鎀	金 亻 丨 彡
鎁	金 耳 阝
鎂	金 羊 大
鎃	金 氵 ⺁ 𧘇
鎄	金 {京頭} 𧘇
鎅	金 田 人 {介下}
鎆	金 䒑 月 刂
鎇	金 {眉上} 目
鎈	金 羊 工
鎉	金 日 习 习
鎊	金 亠 丷 方
鎋	金 宀 丰 口
鎌	金 䒑 彐 八
鎍	金 十 冖 糸
鎎	金 气 米
鎐	金 爪 缶
鎑	金 土 厶 皿
鎒	金 辰 寸
鎓	金 八 厶 习
鎔	金 穴 人 口
鎕	金 广 肀 口
鎖	金 小 貝
鎗	金 人 丶 口
鎘	金 一 口 丨
鎙	金 䒑 屮 月
鎚	金 𠂤 辶
鎛	金 甫 寸
鎜	舟 殳 金
鎝	金 艹 合
鎞	金 {囟框} 乂 匕
鎟	金 又 又 木
鎠	金 罒 一 止
鎡	金 䒑 幺 幺
鎢	金 烏
鎣	火 火 冖 金
鎤	金 日 小 兀
鎥	亻 丨 夊 金
鎦	金 卯 田
鎧	金 山 一 䒑
鎨	金 隹 十
鎩	金 乂 木 殳
鎪	金 臼 丨 又
鎫	金 {向框} 乂 夊
鎬	金 高
鎭	金 匕 目 八
鎮	金 十 且 八
鎯	金 丶 彐 阝
鎰	金 䒑 八 皿
鎱	金 土 口 𧘇
鎲	金 尚 儿
鎳	金 自 木
鎴	金 自 心
鎵	金 宀 豕
鎶	金 丁 口 口
鎷	金 馬
鎸	金 隹 乃
鎹	金 䒑 大 辶
鎺	金 示 且
鎻	金 巛 貝
鎼	金 {虎头} 手
鎽	金 山 夊 丰
鎾	金 日 皿
鎿	金 合 手
鏀	金 鹵
鏁	金 巛 日 木
鏂	金 匚 口 口
鏃	金 方 𠂉 矢
鏄	金 {專上} 寸
鏅	金 亻 丨 月
鏆	金 {母框} 十 貝
鏇	金 方 𠂉 龰
鏈	金 車 辶
鏉	金 木 口 欠
鏋	金 卄 一 入
鏌	金 艹 日 大
鏍	金 田 糸
鏎	金 日 卄 キ
鏏	金 丰 丰 彐
鏐	金 习 习 彡
鏑	金 亠 丷 古
鏒	金 厶 厶 彡
鏓	金 {囟框} 夊 心
鏔	金 宀 一 八
鏕	金 鹿
鏗	金 臣 又 土
鏘	金 爿 月 寸
鏙	金 山 隹
鏚	金 戊 上 小
鏛	金 尚 巾
鏜	金 尚 土
鏝	金 日 罒 又
鏞	金 广 肀 月
鏟	金 立 丿 生
鏠	金 夊 丰 辶
鏡	金 立 日 儿
鏢	金 西 示
鏣	金 广 卄 灬
鏤	金 口 十 女
鏥	金 宀 亻 日
鏦	金 彳 人 龰
鏧	士 {眉上} 殳 金
鏨	車 斤 金
鏩	金 車 斤
鏪	金 艹 日 日
鏫	金 禾 刂 木
鏬	金 {虎头} 丿 {于下}
鏭	金 丿 米 心
鏮	金 广 彐 水
鏯	金 大 乂 乂
鏰	金 山 月 月
鏱	金 立 早
鏲	金 亠 幺 牛
鏳	金 丷 日 日
鏴	金 足 夊 口
鏵	金 艹 干 龷
鏶	金 隹 木
鏷	金 业 䒑 夫
鏸	金 {專上} 心
鏹	金 弓 口 虫
鏺	金 癶 弓 殳
鏻	金 米 夕 ヰ
鏼	金 竹 木 冂
鏽	金 肀 片 一
鏾	金 龷 月 夊
鏿	金 尚 木
鐀	金 口 丄 貝
鐁	金 其 斤
鐂	金 丌 匚 田
鐃	金 土 土 兀
鐄	金 龷 由 八
鐅	丷 巾 八 金
鐆	阝 䒑 豕 金
鐇	金 丿 米 田
鐈	金 夭 口 口
鐉	金 巳 巳 八
鐊	金 阝 日 {两撇}
鐋	金 氵 日 {两撇}
鐌	金 冖 口 豕
鐍	金 予 丿 口
鐎	金 隹 灬
鐏	金 丷 酉 寸
鐐	金 大 丷 小
鐑	金 糹 士 口
鐒	金 火 火 力
鐓	金 {京頭} 子 夊
鐔	金 西 早
鐕	金 匚 儿 日
鐖	金 幺 幺 人
鐗	金 門 月
鐘	金 立 里
鐙	金 癶 一 䒑
鐚	金 一 {亞下} 心
鐛	金 日 {京頭} 小
鐜	{京頭} 子 夊 金
鐝	金 厂 䒑 欠
鐞	金 彐 工 寸
鐟	金 夫 夫 日
鐠	金 䒑 业 日
鐡	金 十 戈 䒑
鐢	木 乂 乂 金
鐣	金 尚 手
鐤	金 目 爿 片
鐥	金 羊 䒑 口
鐦	金 門 一 卄
鐧	金 門 日
鐨	金 弓 {介下} 貝
鐩	金 䒑 豕 辶
鐪	金 {虎头} 田 力
鐫	金 隹 {雋下}
鐬	金 止 戊 小
鐭	金 {向框} 米 大
鐮	金 广 䒑 八
鐯	金 艹 耂 日
鐰	金 口 口 木
鐱	金 僉
鐲	金 罒 勹 虫
鐳	金 雨 田
鐴	金 尸 口 辛
鐵	金 十 戈 王
鐶	金 罒 一 𧘇
鐷	金 艹 世 木
鐸	金 罒 土 十
鐹	金 咼 辶
鐺	金 尚 田
鐻	金 {虎头} 豕
鐼	金 十 卄 貝
鐽	金 土 羊 辶
鐿	金 立 日 心
鑀	金 爪 冖 夊
鑁	金 𠂭 凵 夊
鑂	金 千 黑
鑃	金 习 习 隹
鑄	金 士 乛 寸
鑅	金 火 火 木
鑆	金 业 羊 寸
鑇	金 亠 丷 二
鑈	金 一 八 乂
鑉	金 艹 土 皿
鑊	金 艹 隹 又
鑋	車 一 巛 金
鑌	金 宀 一 貝
鑍	貝 貝 金
鑎	金 匚 口 貝
鑏	金 宀 心 丁
鑐	金 雨 而
鑑	金 臣 {⺮右} 皿
鑒	臣 {⺮右} 罒 金
鑓	金 口 丄 辶
鑔	金 宀 {祭上} 示
鑕	金 斤 斤 貝
鑖	金 艹 罒 丶
鑗	金 禾 勹 水
鑘	金 田 田 田
鑙	金 禾 尤 日
鑚	金 夫 夫 貝
鑛	金 广 龷 八
鑜	金 尚 貝
鑝	金 艹 夊 辶
鑞	金 巛 囗 {鼠下}
鑟	金 士 罒 貝
鑠	金 白 幺 木
鑡	金 齒
鑢	金 {虎头} 田 心
鑣	金 鹿 灬
鑤	金 日 龷 水
鑥	金 魚 日
鑦	金 臣 又 貝
鑧	金 宀 艹 丶
鑨	金 立 月 {龍右}
鑩	金 王 口 口
鑪	金 {虎头} 田 皿
鑬	金 臣 {⺮右} 見
鑭	金 門 木 丷
鑮	金 艹 氵 寸
鑯	金 人 人 一
鑰	金 合 口 冊
鑱	金 冖 口 丶
鑲	金 {京頭} 口 𧘇
鑳	金 宀 {冓上} 足
鑴	金 山 隹 口
鑵	金 艹 口 隹
鑶	金 艹 戈 臣
鑷	金 耳 耳 耳
鑸	金 田 田 土
鑹	金 穴 臼 {鼠下}
鑺	金 目 目 隹
鑻	金 木 乂 手
鑼	金 罒 糹 隹
鑽	金 ⺧ 儿 貝
鑾	言 糹 糹 金
鑿	业 䒑 十 金
钀	金 {虎头} 一 犬
钁	金 目 目 又
钂	金 尚 黑
钃	金 尸 水 虫
钄	金 艹 門 丷
钑	钅 乃 乀
钖	钅 𠄎 {两撇}
钘	钅 一 卄
铇	钅 勹 巳
铏	钅 一 卄 刂
铓	钅 艹 亡
铔	钅 丌 䒑
铚	钅 至
铦	钅 舌
铻	钅 一 {五下} 口
锜	钅 大 丁 口
锠	钅 日 日
锧	钅 ⺁ 十 贝
锳	钅 艹 冂 大
锽	钅 白 王
镃	钅 䒑 幺 幺
镈	钅 甫 寸
镋	钅 尚 儿
镕	钅 穴 人 口
镚	钅 山 月 月
镠	钅 习 习 彡
镮	钅 罒 一 𧘇
镴	钅 巛 囗 {鼠下}
镵	钅 冖 口 丶
長	長
镸	镸
镹	镸 冖 丶
镺	镸 夭
镻	镸 丿 夫
镼	镸 尸 屮 凵
镽	镸 大 丷 小
镾	镸 一 八 乂
門	門
閁	門 丿
閂	門 一
閃	門 人
閄	門 人
閅	門 丁
閆	門 三
閇	門 下
閈	門 干
閉	門 {于下} 丿
閊	門 山
開	門 一 卄
閌	門 亠 几
閍	門 方
閎	門 {左上} 厶
閏	門 王
閐	門 毛
閑	門 木
閒	門 月
間	門 日
閔	門 文
閕	門 牙
閖	門 水
閗	門 ⺀ 十
閘	門 甲
閙	門 亠 巾
閚	門 立
閛	門 干 丷
閜	門 丁 口
閝	門 人 丶 マ
閞	門 厶 卄
閟	門 心 丿
閠	門 王 丶
閡	門 亥
関	門 䒑 大
閣	門 夊 口
閤	門 合
閥	門 亻 戈
閦	門 人 人 人
閧	門 龷 八
閨	門 土 土
閩	門 虫
閪	門 西
閫	門 囗 木
閬	門 丶 艮
閭	門 口 口
閮	門 壬 廴
閯	門 氵 小 丿
閰	門 臼
閱	門 八 口 儿
閲	門 丷 口 儿
閳	門 車
閴	門 貝
閵	門 隹
閶	門 日 日
閷	乂 木 門 人
閸	門 一 {亞下}
閹	門 大 电
閺	門 日 文
閻	門 冖 臼
閼	門 方 人 ⺀
閽	門 {卬左} 七 日
閾	門 戈 口 一
閿	門 爪 冖 又
闀	門 龷 八 巳
闁	門 門
闂	門 丷 夫 㔾
闃	門 目 犬
闄	門 西 女
闅	門 目 卜 又
闆	門 口 口 口
闇	門 立 日
闈	門 韋
闉	門 西 土
闊	門 氵 舌
闋	門 癶 一 大
闌	門 木 囗 丷
闍	門 耂 日
闎	門 白 水
闏	門 風
闐	門 十 且 八
闑	門 自 木
闒	門 日 习 习
闓	門 山 一 䒑
闔	門 土 厶 皿
闕	門 䒑 屮 欠
闖	門 馬
闗	門 幺 幺 灬
闘	門 一 口 寸
闙	門 户 口 夊
闚	門 夫 見
闛	門 尚 土
關	門 幺 幺 丱
闝	門 貝 夊
闞	門 乛 耳 夊
闟	門 合 习 习
闠	門 口 丄 貝
闡	門 口 口 十
闢	門 尸 口 辛
闣	門 尚 田
闤	門 罒 一 𧘇
闥	門 土 羊 辶
闦	門 冂 龷 䒑
闧	門 土 口 辶
闬	门 干
闿	门 山 己
阇	门 耂 日
阓	门 口 丄 贝
阘	门 日 习 习
阛	门 罒 一 𧘇
阞	阝 力
阠	阝 乛 十
阣	阝 𠂉 乙
阤	阝 也
阥	阝 水
阦	阝 火
阧	阝 ⺀ 十
阨	阝 厂 㔾
阩	阝 丿 卄
阫	阝 不
阬	阝 亠 几
阭	阝 厶 儿
阯	阝 止
阰	阝 匕 匕
阷	阝 一 止
阸	阝 户 乙
阹	阝 土 厶
阺	阝 {卬左} 七 丶
阾	阝 人 丶 マ
陁	阝 𠂉 也
陃	阝 一 冂 人
陊	阝 夕 夕
陎	阝 牛 八
陏	阝 {左上} 月
陑	阝 而
陒	阝 冖 厂 㔾
陓	阝 大 一 丂
陖	阝 厶 八 夊
陗	阝 小 月
陘	阝 一 巛 工
陙	阝 辰
陚	阝 一 弋 止
陜	阝 大 人 人
陝	阝 大 入 入
陞	阝 丿 卄 土
陠	阝 甫
陣	阝 車
陥	阝 冖 丨 日
陦	阝 丰 寸
陫	阝 非
陭	阝 大 丁 口
陮	阝 隹
陯	阝 人 一 冊
陰	阝 人 丶 厶
陱	阝 勹 米
陳	阝 木 日
陸	阝 土 八 土
陹	阝 丿 卄 日
険	阝 合 人
陻	阝 西 土
陼	阝 耂 日
陽	阝 日 一 {两撇}
陾	阝 而 大
陿	阝 匚 大 人
隀	阝 千 里
隁	阝 匚 日 女
隂	阝 人 镸
隃	阝 人 一 刂
隄	阝 日 一 龰
隇	阝 戊 一 女
隉	阝 臼 工
隊	阝 䒑 豕
隌	阝 立 日
階	阝 匕 匕 白
隑	阝 山 一 䒑
隒	阝 䒑 彐 八
隓	阝 {左上} 工 工
隕	阝 口 貝
隖	阝 烏
隚	阝 尚 土
際	阝 {祭上} 示
隝	阝 鳥
隞	阝 龶 勹 夊
隟	阝 巛 日 木
隠	阝 爪 彐 心
隡	阝 立 丿 生
隢	阝 土 土 兀
隣	阝 米 夕 ヰ
隤	阝 口 丄 貝
隥	阝 癶 一 䒑
隦	阝 尸 口 辛
隨	阝 {左上} 工 辶
隩	阝 {向框} 米 大
險	阝 僉
隫	阝 十 卄 貝
隬	阝 一 八 乂
隭	阝 雨 而
隮	阝 亠 丷 二
隯	阝 士 乛 寸
隱	阝 爪 工 心
隲	阝 小 丿 馬
隴	阝 立 月 {龍右}
隵	阝 {虎头} 一 戈
隷	士 示 彐 水
隸	木 示 彐 水
隺	冖 隹
隻	隹 又
隿	弋 隹
雂	人 丶 乛 隹
雃	一 卄 隹
雈	卝 隹
雊	勹 口 隹
雋	隹 {雋下}
雐	{虎头} 隹
雑	九 木 隹
雓	人 一 木 隹
雔	隹 隹
雖	口 虫 隹
雗	十 早 𠂉 隹
雘	⺆ 亠 艹 又
雙	隹 隹 又
雚	艹 口 口 隹
雛	勹 屮 勹 隹
雜	亠 人 人 隹
雝	巛 口 巴 隹
雞	爪 幺 大 隹
雟	屮 隹 冂 口
雡	习 习 人 隹
離	文 凵 冂 隹
難	卄 一 口 隹
雤	臼 乂 乂 隹
雥	隹 隹 隹
雦	隹 隹 隹
雧	隹 隹 隹 木
雫	雨 下
雬	雨 木
雭	雨 乃 乀
雮	雨 毛
雰	雨 八 刀
雱	雨 方
雲	雨 二 厶
雴	雨 立
雵	雨 冂 大
雸	雨 卄 二
雺	雨 予 丿
電	雨 电
雼	雨 石
雽	雨 丿 丷 {于下}
雿	雨 儿 二 二
霂	雨 氵 木
霃	雨 氵 冖 儿
霅	雨 言
霊	雨 一 丌 䒑
霋	雨 十 彐 女
霌	雨 ⺆ 土 口
霐	雨 氵 弓 厶
霑	雨 氵 卜 口
霒	雨 二 厶 乛
霔	雨 氵 丶 王
霕	雨 二 厶 凵
霗	雨 氵 人 マ
霘	雨 氵 冂 口
霙	雨 艹 冂 大
霚	雨 予 丿 夊
霛	雨 弓 弓 弓
霝	雨 口 口 口
霟	雨 氵 龷 八
霠	雨 立 人 乛
霡	雨 月 丶 水
霢	雨 月 ⺁ 𧘇
霣	雨 口 貝
霤	雨 卯 田
霥	雨 冖 一 豕
霦	雨 木 木 彡
霧	雨 予 丿 力
霨	雨 尸 示 寸
霩	雨 {京頭} 子 阝
霫	雨 习 习 白
霬	雨 田 龷 八
霮	雨 氵 其 乚
霯	雨 癶 一 䒑
霱	雨 予 丿 口
霳	雨 阝 夊 生
霴	雨 二 厶 水
霵	雨 口 耳 戈
霶	雨 氵 亠 方
霷	雨 日 日 {两撇}
霺	雨 {微上} 一 几
霻	雨 冂 龷 䒑
霼	雨 二 厶 米
霽	雨 亠 丷 二
霿	雨 予 丿 目
靀	雨 艹 冖 豕
靁	雨 田 田 田
靂	雨 厂 禾 止
靃	雨 隹 隹
靄	雨 言 日 乚
靅	雨 二 厶 貝
靆	雨 二 厶 辶
靇	雨 立 月 {龍右}
靈	雨 口 口 人
靉	雨 二 厶 夊
靊	雨 山 丰 䒑
靋	雨 氵 厂 止
靌	雨 宀 王 貝
靍	雨 隹 鳥
靎	雨 金 鳥
靏	雨 冖 隹 鳥
靐	雨 田 雨 田
靑	龶 冂 丄
靔	龶 月 气
靕	一 止 龶 月
靗	龶 月 小 兀
靘	龶 月 冖 巴
靚	龶 月 見
靜	龶 月 爪 亅
靝	龶 月 气 米
靟	非 毛
靣	丆 囗 口
靤	面 勹 巳
靦	面 見
靧	面 口 丄 貝
靨	厂 日 月 面
靪	革 丁
靫	革 又 丶
靬	革 干
靭	革 刀 丶
靮	革 勹 丶
靯	革 土
靰	革 兀
靱	革 刀 乀
靲	革 人 丶 乛
靵	革 丑
靷	革 弓 丨
靸	革 乃 乀
靹	革 冂 人
靺	革 末
靻	革 且
靽	革 丷 キ
靾	革 世
靿	革 幺 力
鞀	革 刀 口
鞁	革 皮
鞂	革 禾
鞃	革 弓 厶
鞄	革 勹 巳
鞆	革 一 冂 人
鞇	革 囗 大
鞈	革 合
鞉	革 儿 二 二
鞊	革 士 口
鞌	宀 女 革
鞎	革 艮
鞏	工 几 丶 革
鞐	革 上 下
鞓	革 口 王
鞕	革 一 日 乂
鞖	革 爪 女
鞗	亻 丨 夊 革
鞙	革 口 月
鞚	革 穴 工
鞛	革 立 口
鞜	革 水 日
鞝	革 尚
鞞	革 {卑上} 十
鞟	革 {京頭} 子
鞡	革 扌 立
鞢	革 世 木
鞤	土 土 寸 革
鞥	革 合 卄
鞦	革 禾 火
鞧	革 丷 酉
鞨	革 日 勹 乚
鞩	革 小 月 刂
鞪	予 丿 夊 革
鞬	革 彐 キ 廴
鞮	革 日 一 龰
鞰	革 日 皿
鞱	革 爪 臼
鞳	革 艹 合
鞵	革 爪 幺 大
鞶	舟 殳 革
鞷	一 口 冂 革
鞸	革 日 卄 キ
鞹	革 {京頭} 子 阝
鞺	革 尚 土
鞻	革 口 十 女
鞼	革 口 丄 貝
鞽	革 夭 口 口
鞾	革 艹 干 龷
鞿	革 幺 幺 人
韀	革 {鹿上} 丂 灬
韁	革 一 田 一
韂	革 冖 厂 言
韃	革 土 羊 辶
韄	革 艹 隹 又
韅	革 日 幺 灬
韆	革 西 大 辶
韇	革 士 罒 貝
韈	革 艹 罒 丶
韉	革 艹 {鹿上} 灬
韊	革 艹 門 丷
韋	韋
韌	韋 刀 丶
韍	韋 {左上} 又 丶
韎	韋 末
韏	丷 夫 韋
韐	韋 合
韑	小 兀 韋
韒	韋 小 月
韓	十 早 韋
韔	韋 長
韕	韋 {京頭} 子
韖	韋 予 丿 木
韗	韋 冖 車
韘	韋 世 木
韙	日 一 龰 韋
韚	韋 革
韛	韋 龷 丿 用
韜	韋 爪 臼
韝	韋 {冓上} 冂 土
韞	韋 日 皿
韟	韋 白 大 十
韠	韋 日 卄 キ
韡	韋 艹 干 龷
韢	韋 {專上} 心
韣	韋 罒 勹 虫
韤	韋 艹 罒 丶
韥	韋 士 罒 貝
韨	キ 乛 {左上} 丶
韮	艹 非 一
韯	十 戈 非 一
韰	卜 夕 又 一
韱	人 人 戈 一
韲	亠 丷 丨 一
韴	立 日 一 巾
韷	立 日 屮 凵
韸	立 日 夊 丰
韹	立 日 白 王
韺	立 日 艹 大
韻	立 日 口 貝
韼	立 日 夊 辶
韽	人 丶 乛 日
韾	士 {眉上} 殳 日
響	{纟上} 丿 丶 日
頀	立 日 艹 又
頁	丆 貝
頂	丁 丆 貝
頃	匕 丆 貝
頄	九 丆 貝
項	工 丆 貝
順	川 丆 貝
頇	干 丆 貝
須	彡 丆 貝
頉	止 丆 貝
頊	王 丆 貝
頋	厂 㔾 丆 貝
頌	八 厶 丆 貝
頍	十 又 丆 貝
頎	斤 丆 貝
頏	亠 几 丆 貝
預	予 丆 貝
頑	一 兀 丆 貝
頒	八 刀 丆 貝
頓	七 凵 丆 貝
頔	由 丆 貝
頕	卜 口 丆 貝
頖	丷 キ 丆 貝
頗	皮 丆 貝
領	人 丶 マ 貝
頙	一 止 丆 貝
頚	又 土 丆 貝
頛	丰 八 丆 貝
頜	合 丆 貝
頝	亠 八 乂 貝
頞	宀 女 丆 貝
頟	夊 口 丆 貝
頠	冖 厂 㔾 貝
頡	士 口 丆 貝
頢	舌 丆 貝
頣	臣 丆 貝
頤	臣 丆 貝
頥	丨 臣 丆 貝
頦	亥 丆 貝
頧	𠂤 丆 貝
頨	习 习 丆 貝
頩	䒑 卄 丆 貝
頪	米 丆 貝
頫	儿 二 二 貝
頬	夫 丷 丆 貝
頭	一 口 䒑 貝
頮	水 卄 丆 貝
頯	月 卄 丆 貝
頰	大 人 人 貝
頱	爪 寸 丆 貝
頲	壬 廴 丆 貝
頳	土 {介下} 八 貝
頴	匕 示 丆 貝
頵	彐 丿 口 貝
頶	⺧ 口 丆 貝
頷	人 丶 乛 貝
頸	一 巛 工 貝
頹	禾 儿 丆 貝
頺	禾 乃 丆 貝
頻	止 小 丆 貝
頼	木 口 丆 貝
頽	禾 几 丆 貝
頾	彡 丆 貝 匕
頿	彡 止 匕 貝
顀	隹 丆 貝
顁	宀 一 龰 貝
顂	來 丆 貝
顃	火 火 丆 貝
顄	乛 水 凵 貝
顅	户 月 丆 貝
顆	日 木 丆 貝
顇	亠 人 人 貝
顈	匕 糸 丆 貝
顉	金 丆 貝
顊	𠂤 十 丆 貝
顋	田 心 丆 貝
題	日 一 龰 貝
額	宀 夊 口 貝
顎	口 口 一 貝
顏	文 厂 彡 貝
顐	冖 車 丆 貝
顑	戊 一 口 貝
顒	禺 丆 貝
顓	山 而 丆 貝
顔	立 丿 彡 貝
顕	日 业 丆 貝
顖	{囟框} 乂 心 貝
顗	山 一 口 貝
願	厂 白 小 貝
顙	又 又 又 貝
顚	匕 目 乚 貝
顛	十 且 八 貝
顜	{冓上} 冂 土 貝
顝	骨 丆 貝
類	米 犬 丆 貝
顟	习 习 人 貝
顠	西 示 丆 貝
顡	立 豕 丆 貝
顢	卄 一 巾 貝
顣	戊 上 小 貝
顤	土 土 土 貝
顥	日 {京頭} 小 貝
顦	隹 灬 丆 貝
顧	户 隹 丆 貝
顨	丆 貝 丆 丌
顩	僉 丆 貝
顪	止 戊 一 貝
顫	亠 囗 口 貝
顬	雨 而 丆 貝
顭	艹 罒 冖 貝
顮	宀 一 小 貝
顯	日 幺 幺 貝
顰	止 小 丆 十
顱	{虎头} 田 皿 貝
顲	火 火 亠 貝
顳	耳 耳 耳 貝
顴	艹 口 口 貝
颋	壬 廴 丆 贝
颎	匕 火 丆 贝
颒	水 卄 丆 贝
颕	匕 示 丆 贝
颙	禺 丆 贝
颣	米 糸 丆 贝
風	風
颩	風 彡
颪	下 風
颫	風 夫
颬	風 牙
颭	風 卜 口
颮	風 勹 巳
颯	立 風
颰	風 {左上} 又 丶
颱	風 厶 口
颲	風 一 夕 刂
颳	風 舌
颴	風 𠂉 乛 龰
颵	風 小 月
颶	風 且 八
颷	風 火 火
颸	風 田 心
颹	風 韋
颺	風 日 一 {两撇}
颻	爪 缶 風
颼	風 臼 丨 又
颽	山 一 口 風
颾	風 又 丶 虫
颿	馬 風
飀	風 卯 田
飁	习 习 白 風
飂	風 习 习 彡
飃	風 西 示
飄	西 示 風
飅	風 丌 匚 田
飆	犬 犬 犬 風
飇	風 犬 犬 犬
飈	風 火 火 火
飉	風 大 丷 小
飊	火 火 火 風
飋	風 王 王 丿
飌	艹 口 口 風
飍	風 風 風
飏	几 乂 𠄎 {两撇}
飐	几 乂 卜 口
飔	几 乂 田 心
飖	爪 缶 几 乂
飗	几 乂 卯 田
飛	飛
飜	丿 米 田 飛
飝	飛 飛 飛
飠	食
飡	二 食
飢	食 几
飣	食 丁
飤	食 人
飥	食 丿 七
飦	食 干
飩	食 七 凵
飪	食 壬
飫	食 夭
飬	丷 夫 丶 艮
飭	食 𠂉 力
飮	食 欠
飯	食 ⺁ 又
飰	食 亠 卜
飱	一 夕 食
飲	食 欠
飳	食 丶 王
飴	食 厶 口
飵	食 𠂉 {乍下}
飶	食 心 丿
飷	食 且
飸	口 丂 食
飹	食 卯
飺	止 匕 食
飻	食 人 彡
飼	食 乛 一 口
飽	食 勹 巳
飾	食 𠂉 巾
飿	食 屮 凵
餀	食 艹 乂
餁	食 亻 壬
餂	食 舌
餃	食 亠 八 乂
餄	食 合
餅	食 䒑 卄
餆	食 儿 二 二
餇	食 冂 一 口
餈	二 欠 食
餉	食 向
養	䒑 夫 丶 艮
餋	丷 夫 食
餌	食 耳
餎	食 夊 口
餏	食 亠 𧘇
餑	食 十 冖 子
餒	食 爪 女
餓	食 丿 扌 戈
餔	食 甫
餕	食 厶 八 夊
餖	食 一 口 䒑
餗	食 木 口
餘	食 人 一 木
餙	食 乂 {左上} 巾
餚	食 乂 {左上} 月
餛	食 日 匕 匕
餜	食 日 木
餝	食 艹 方
餞	食 戈 戈
餟	食 又 又 又
餠	食 丿 干 干
餡	食 冖 臼
餢	食 立 口
餣	食 大 电
餤	食 火 火
餥	非 食
餦	食 長
餧	食 禾 女
館	食 宀 尸 コ
餩	食 人 亥
餪	食 而 大
餫	食 冖 車
餬	食 古 月
餭	食 白 王
餯	食 {互中} 豕
餰	食 彳 氵 亍
餱	食 亻 コ 矢
餲	食 日 勹 乚
餳	食 日 一 {两撇}
餴	食 大 十 卄
餵	食 田 {畏下}
餶	食 骨
餷	食 木 日 一
餸	食 䒑 大 辶
餹	食 广 肀 口
餺	食 甫 寸
餻	食 羊 灬
餼	食 气 米
餽	食 鬼
餾	食 卯 田
餿	食 臼 丨 又
饀	食 爪 臼
饁	食 土 厶 皿
饂	食 日 皿
饃	食 艹 日 大
饄	食 尚 土
饅	食 日 罒 又
饆	食 日 卄 キ
饇	食 匚 口 口
饈	食 羊 丑
饉	食 革 二
饊	食 龷 月 夊
饋	食 口 丄 貝
饌	食 巳 巳 八
饍	食 羊 䒑 口
饎	食 士 口 口
饏	乛 耳 夊 食
饐	食 士 冖 䒑
饑	食 幺 幺 人
饒	食 土 土 兀
饓	食 尚 木
饖	食 止 戊 小
饗	{纟上} 丿 丶 食
饘	食 亠 囗 一
饙	食 十 卄 貝
饚	食 艹 土 皿
饛	食 艹 冖 豕
饜	厂 日 月 食
饝	食 麻 石
饞	食 冖 口 丶
饟	食 {京頭} 口 𧘇
饠	食 罒 糹 隹
饡	食 ⺧ 儿 貝
饢	食 十 口 𧘇
饤	饣 丁
饦	饣 丿 七
饳	饣 屮 凵
饸	饣 合
饹	饣 夊 口
饻	饣 亠 𧘇
饾	饣 一 口 䒑
馂	饣 厶 八 夊
馃	饣 日 木
馉	饣 骨
馌	饣 土 厶 皿
馎	饣 甫 寸
馚	禾 日 八 刀
馛	禾 日 {左上} 丶
馜	禾 日 尸 匕
馝	禾 日 心 丿
馞	禾 日 十 子
馟	禾 日 爪 子
馠	禾 日 人 口
馡	禾 日 非
馢	禾 日 戈 戈
馣	禾 日 大 电
馤	禾 日 日 乚
馦	禾 日 䒑 八
馧	禾 日 日 皿
馩	禾 日 十 貝
馪	禾 日 宀 貝
馫	禾 日 禾 日
馬	馬
馭	馬 又
馮	二 馬
馯	馬 干
馰	馬 勹 丶
馱	馬 大
馲	馬 丿 七
馳	馬 也
馴	馬 川
馵	馬 卄
馶	馬 十 又
馷	馬 一 巾
馸	馬 斤
馹	馬 日
馺	馬 乃 乀
馻	馬 厶 儿
馼	馬 文
馽	馬 口 丨
馾	馬 冖 儿
馿	馬 户
駀	馬 尤
駁	馬 乂 乂
駂	匕 十 馬
駃	馬 コ 人
駄	馬 大 丶
駅	馬 尸 乀
駆	馬 匚 乂
駇	馬 夊
駈	馬 斤 一
駉	馬 冂 口
駊	馬 皮
駋	馬 刀 口
駌	夕 㔾 馬
駍	馬 干 丷
駎	馬 由
駏	馬 匚 コ
駐	馬 丶 王
駑	女 又 馬
駒	馬 勹 口
駓	馬 不 一
駔	馬 且
駕	力 口 馬
駖	馬 人 丶 マ
駗	馬 人 彡
駘	馬 厶 口
駙	馬 亻 寸
駚	馬 冂 大
駛	馬 口 乂
駜	馬 心 丿
駝	馬 宀 匕
駞	馬 𠂉 也
駟	馬 囗 儿
駠	馬 卯
駡	口 口 馬
駢	馬 䒑 卄
駣	馬 儿 二 二
駤	馬 至
駥	馬 戈 {左上}
駦	丷 夫 馬
駧	馬 冂 一 口
駨	馬 勹 日
駩	馬 人 王
駪	馬 ⺧ 儿
駫	馬 小 兀
駬	馬 耳
駭	馬 亥
駮	馬 亠 八 乂
駯	馬 牛 八
駰	馬 囗 大
駱	馬 夊 口
駲	馬 ⺍ 川
駳	馬 丿 止 廴
駴	馬 戈 卄
駵	馬 丌 匚 コ
駶	馬 尸 乛 口
駷	馬 木 口
駸	馬 彐 冖 又
駹	馬 尤 彡
駺	馬 丶 艮
駻	馬 日 干
駼	馬 人 一 木
駽	馬 口 月
駾	馬 丷 口 儿
駿	馬 厶 八 夊
騀	馬 丿 扌 戈
騁	馬 由 丂
騂	馬 辛
騃	馬 厶 矢
騄	馬 彐 水
騅	馬 隹
騆	馬 ⺆ 土 口
騇	馬 人 干 口
騈	馬 丿 干 干
騉	馬 日 匕 匕
騊	馬 勹 缶
騋	馬 來
騌	馬 宀 示
騍	馬 日 木
騎	馬 大 丁 口
騏	馬 其
騐	馬 人 丶 心
騑	馬 非
騒	馬 又 虫
験	馬 合 人
騔	馬 日 勹 乚
騕	馬 西 女
騖	予 丿 夊 馬
騗	户 冊 馬
騘	馬 勹 {两撇} 心
騙	馬 户 冊
騚	馬 䒑 月 刂
騛	馬 飛
騜	馬 白 王
騝	馬 彐 キ 廴
騞	馬 丰 石
騟	馬 人 一 刂
騠	馬 日 一 龰
騡	馬 白 水
騢	馬 尸 二 又
騣	馬 乂 凵 夊
騤	馬 癶 一 大
騥	馬 予 丿 木
騦	馬 田 心
騧	馬 咼
騨	馬 ⺍ 日 十
騩	馬 鬼
騪	馬 臼 丨 又
騫	宀 {冓上} 八 馬
騬	馬 禾 丬 匕
騭	阝 止 小 馬
騮	馬 卯 田
騯	馬 亠 丷 方
騰	月 丷 夫 馬
騱	馬 爪 幺 大
騲	馬 艹 早
騳	馬 馬
騴	馬 日 宀 女
騵	馬 厂 白 小
騶	馬 勹 屮 屮
騷	馬 又 丶 虫
騸	馬 户 习 习
騹	馬 革 二
騺	土 䒑 十 馬
騻	馬 大 乂 乂
騼	馬 鹿
騽	馬 习 习 白
騾	馬 田 糸
騿	馬 立 早
驀	艹 日 大 馬
驁	龶 勹 夊 馬
驂	馬 厶 厶 彡
驃	馬 西 示
驄	馬 {囟框} 夊 心
驅	馬 匚 口 口
驆	馬 日 卄 キ
驇	土 八 土 馬
驈	馬 予 丿 口
驉	馬 {虎头} 业
驊	馬 艹 干 龷
驋	馬 癶 弓 殳
驌	馬 肀 片 一
驍	馬 土 土 兀
驎	馬 米 夕 ヰ
驏	馬 尸 子 子
驐	馬 {京頭} 子 夊
驑	馬 丌 匚 田
驒	馬 口 口 十
驓	馬 丷 日 日
驔	馬 西 早
驕	馬 夭 口 口
驖	馬 十 戈 王
驗	馬 僉
驘	{贏頭} 馬
驙	馬 亠 囗 一
驚	艹 勹 口 馬
驛	馬 罒 土 十
驜	馬 业 羊 八
驝	馬 士 冖 木
驞	馬 宀 一 貝
驟	馬 耳 又 二
驠	馬 卄 一 灬
驡	立 月 {龍右} 馬
驢	馬 {虎头} 田 皿
驣	馬 丷 夫 馬
驤	馬 {京頭} 口 𧘇
驥	馬 丬 匕 八
驦	馬 雨 木 目
驧	馬 革 勹 米
驨	馬 山 隹 口
驩	馬 艹 口 隹
驪	馬 一 {冂丶} 鹿
驫	馬 馬 馬
驲	马 日
骃	马 囗 大
骉	马 马 马
骍	马 辛
骎	马 彐 冖 又
骔	马 宀 示
骕	马 肀 {介下} 八
骙	马 癶 一 大
骦	马 雨 木 目
骩	骨 九
骪	骨 几 丶
骫	骨 九 丶
骬	骨 一 {于下}
骭	骨 干
骮	骨 弋
骯	骨 亠 几
骲	骨 勹 巳
骳	骨 皮
骴	骨 止 匕
骵	骨 木 一
骹	骨 亠 八 乂
骻	骨 大 一 丂
骽	骨 爪 女
骾	骨 一 日 乂
骿	骨 䒑 卄
髃	骨 禺
髄	骨 {左上} 月 辶
髆	骨 甫 寸
髇	骨 高
髈	骨 亠 丷 方
髉	骨 冖 隹
髊	骨 羊 工
髍	骨 麻
髎	骨 习 习 彡
髏	骨 口 十 女
髐	骨 土 土 兀
髒	骨 艹 一 卄
體	骨 冂 龷 䒑
髕	骨 宀 一 貝
髖	骨 宀 艹 丶
髗	骨 {虎头} 田 皿
髙	亠 〢 二 口
髚	高 亠 几
髛	高 尸 九
髜	高 日 丿 卄
髝	高 火 火 力
髞	高 口 口 木
髠	髟 几
髢	髟 也
髣	髟 方
髤	髟 木
髥	髟 冂 二
髧	髟 冖 儿
髨	髟 一 兀
髩	髟 丅 乚 乛
髪	髟 {左上} 又
髬	髟 不 一
髮	髟 {左上} 又 丶
髰	髟 世
髱	髟 勹 巳
髲	髟 皮
髳	髟 予 丿
髴	髟 弓 {介下}
髵	髟 而
髶	髟 耳
髷	髟 冂 龷
髸	髟 龷 八
髺	髟 舌
髼	髟 夊 丰
髽	髟 人 人 土
髾	髟 小 月
髿	髟 氵 小 丿
鬀	髟 丷 弓 丿
鬁	髟 禾 刂
鬂	髟 斤 一 八
鬄	髟 日 勹 {两撇}
鬅	髟 月 月
鬆	髟 木 八 厶
鬇	髟 冖 彐 亅
鬉	髟 乂 凵 夊
鬊	髟 𡗗 日
鬋	髟 䒑 月 刂
鬌	髟 {左上} 工 月
鬍	髟 古 月
鬎	髟 木 口 刂
鬐	髟 耂 匕 日
鬑	髟 䒑 彐 八
鬒	髟 十 且 八
鬔	髟 夊 丰 辶
鬕	髟 艹 日 大
鬖	髟 厶 厶 彡
鬗	髟 卄 一 入
鬘	髟 日 罒 又
鬙	髟 丷 日 日
鬚	髟 彡 丆 貝
鬛	髟 囗 乂 {鼠下}
鬜	髟 門 月
鬝	髟 門 日
鬞	髟 冂 龷 辰
鬠	髟 人 一 日
鬡	髟 宀 心 丁
鬢	髟 宀 一 貝
鬤	髟 {京頭} 口 𧘇
鬥	鬥
鬦	鬥 ⺀ 十
鬧	鬥 亠 巾
鬨	鬥 龷 八
鬩	鬥 臼 儿
鬪	鬥 一 口 寸
鬫	鬥 乛 耳 夊
鬬	鬥 {卬左} コ 斤
鬭	鬥 匚 コ 斤
鬮	鬥 丿 {龜下}
鬰	木 乂 乂 彡
鬱	木 缶 木 彡
鬳	{虎头} 一 口 丨
鬴	一 口 冂 甫
鬵	匚 儿 匚 丨
鬶	夫 见 一 丨
鬷	一 口 冂 夊
鬸	一 口 冂 田
鬹	夫 見 一 丨
鬺	一 口 冂 {两撇}
鬽	鬼 彡
鬾	鬼 十 又
鬿	鬼 斤
魀	鬼 人 {介下}
魆	鬼 戈 乚
魊	鬼 戈 口 一
魋	鬼 隹
魌	鬼 其
魎	鬼 一 巾 入
魐	鬼 䒑 彐 八
魒	鬼 西 示
魓	鬼 日 卄 キ
魕	鬼 幺 幺 人
魖	鬼 {虎头} 业
魗	士 乛 工 鬼
魘	厂 日 月 鬼
魙	氵 車 斤 鬼
魚	魚
魛	魚 刀
魜	魚 人
魝	魚 刂
魞	魚 入
魟	魚 工
魠	魚 丿 七
魡	魚 勹 丶
魢	魚 己
魣	魚 予
魤	魚 亻 匕
魥	魚 乃 乀
魦	魚 小 丿
魧	魚 亠 几
魨	魚 七 凵
魩	魚 勹 {两撇}
魪	魚 人 {介下}
魫	魚 冖 儿
魬	魚 ⺁ 又
魭	魚 一 兀
魮	魚 匕 匕
魯	魚 日
魰	魚 文
魱	魚 一 彑
魲	魚 户
魳	魚 一 巾
魴	魚 方
魵	魚 八 刀
魶	魚 冂 人
魷	魚 尤
魸	魚 片
魹	魚 毛
魺	魚 丁 口
魻	魚 甲
魼	魚 土 厶
魽	魚 卄 二
魾	魚 不 一
魿	魚 人 丶 マ
鮀	魚 宀 匕
鮁	魚 {左上} 又 丶
鮂	魚 囗 人
鮃	魚 干 丷
鮄	魚 弓 {介下}
鮅	魚 心 丿
鮆	止 匕 魚
鮇	魚 未
鮈	魚 勹 口
鮉	魚 刀 口
鮊	魚 白
鮋	魚 由
鮌	魚 亠 幺
鮍	魚 皮
鮎	魚 卜 口
鮏	魚 生
鮐	魚 厶 口
鮑	魚 勹 巳
鮒	魚 亻 寸
鮓	魚 𠂉 {乍下}
鮔	魚 匚 コ
鮕	魚 古
鮖	魚 石
鮗	魚 夊 ⺀
鮘	魚 亻 弋
鮙	魚 习 习
鮚	魚 士 口
鮛	魚 上 小
鮜	魚 ⺁ 一 口
鮝	丷 夫 魚
鮞	魚 而
鮟	魚 宀 女
鮠	魚 冖 厂 㔾
鮡	魚 儿 二 二
鮢	魚 牛 八
鮣	魚 {卬左} 一 卩
鮤	一 夕 刂 魚
鮥	魚 夊 口
鮦	魚 冂 一 口
鮧	魚 大 弓
鮨	魚 匕 日
鮩	魚 䒑 卄
鮪	魚 {左上} 月
鮫	魚 亠 八 乂
鮬	魚 大 一 丂
鮭	魚 土 土
鮮	魚 羊
鮯	魚 合
鮰	魚 囗 口
鮱	魚 耂 匕
鮲	魚 亻 犬
鮳	魚 耂 丂
鮴	魚 亻 木
鮵	魚 丷 口 儿
鮶	魚 彐 丿 口
鮷	魚 丷 弓 丿
鮸	魚 冖 口 儿
鮹	魚 小 月
鮺	羊 魚
鮻	魚 厶 八 夊
鮼	魚 彐 冖 又
鮽	魚 人 一 木
鮾	魚 爪 女
鮿	魚 耳 乚
鯀	魚 丿 糸
鯁	魚 一 日 乂
鯂	魚 酉
鯃	魚 一 {五下} 口
鯄	魚 一 水 丶
鯅	魚 丿 止 廴
鯆	魚 甫
鯇	魚 宀 一 兀
鯈	亻 丨 夊 魚
鯉	魚 里
鯊	氵 小 丿 魚
鯋	魚 氵 小 丿
鯌	魚 ⺧ 口
鯍	魚 亠 厶 {荒下}
鯎	魚 戊 乛
鯏	魚 禾 刂
鯐	魚 走
鯑	魚 乂 {左上} 巾
鯒	魚 マ 用
鯓	魚 身
鯔	魚 巛 田
鯕	魚 其
鯖	魚 龶 月
鯗	䒑 夫 魚
鯘	魚 禾 女
鯙	魚 {京頭} 子
鯚	魚 禾 子
鯛	魚 ⺆ 土 口
鯜	魚 立 女
鯝	魚 囗 古
鯞	魚 彐 冖 巾
鯟	魚 木 日
鯠	魚 來
鯡	魚 非
鯢	魚 臼 儿
鯣	魚 日 勹 {两撇}
鯤	魚 日 匕 匕
鯥	魚 土 八 土
鯦	魚 夊 卜 口
鯧	魚 日 日
鯨	魚 {京頭} 小
鯩	魚 人 一 冊
鯪	魚 土 八 夊
鯫	魚 耳 又
鯬	禾 勹 丿 魚
鯭	魚 子 皿
鯮	魚 宀 示
鯯	魚 牛 冂 刂
鯰	魚 人 丶 心
鯱	魚 虎
鯲	魚 方 人 ⺀
鯳	魚 广 {卬左} 丶
鯴	魚 乛 丿 虫
鯵	魚 厶 大 彡
鯶	魚 冖 車
鯷	魚 日 一 龰
鯸	魚 亻 コ 矢
鯹	魚 日 生
鯺	魚 耂 日
鯻	魚 木 口 刂
鯼	魚 乂 凵 夊
鯽	魚 彐 厶 卩
鯾	魚 亻 一 乂
鯿	魚 户 冊
鰀	魚 爪 干 又
鰁	魚 白 水
鰂	魚 貝 刂
鰃	魚 田 {畏下}
鰄	魚 戊 一 女
鰅	魚 禺
鰆	魚 𡗗 日
鰇	魚 予 丿 木
鰈	魚 世 木
鰉	魚 白 王
鰊	魚 木 囗 丷
鰋	魚 匚 日 女
鰌	魚 丷 酉
鰍	魚 禾 火
鰎	魚 彐 キ 廴
鰏	魚 一 口 田
鰐	魚 口 口 丂
鰑	魚 日 一 {两撇}
鰒	魚 𠂉 日 夊
鰓	魚 田 心
鰔	魚 戊 一 口
鰕	魚 尸 二 又
鰖	魚 {左上} 工 月
鰗	魚 古 月
鰘	魚 宀 至
鰙	魚 艹 {左上} 口
鰚	魚 宀 一 一
鰛	魚 日 皿
鰜	魚 䒑 彐 八
鰝	魚 高
鰞	魚 烏
鰟	魚 亠 丷 方
鰠	魚 又 丶 虫
鰡	魚 卯 田
鰢	魚 馬
鰣	魚 日 土 寸
鰤	魚 𠂤 一 巾
鰥	魚 罒 水
鰦	魚 䒑 幺 幺
鰧	月 丷 夫 魚
鰨	魚 日 习 习
鰩	魚 爪 缶
鰪	魚 土 厶 皿
鰫	魚 穴 人 口
鰬	魚 {虎头} 文
鰭	魚 耂 匕 日
鰮	魚 囗 人 皿
鰯	魚 弓 二 二
鰰	魚 示 申
鰱	魚 車 辶
鰲	龶 勹 夊 魚
鰳	魚 革 力
鰴	{微上} 一 魚
鰵	𠂉 母 夊 魚
鰶	魚 {祭上} 示
鰷	魚 亻 丨 木
鰸	魚 匚 口 口
鰹	魚 臣 又 土
鰺	魚 厶 厶 彡
鰻	魚 日 罒 又
鰼	魚 习 习 白
鰽	魚 艹 日 日
鰾	魚 西 示
鰿	魚 龶 貝
鱀	彐 厶 匚 魚
鱁	魚 豕 辶
鱂	魚 爿 月 寸
鱃	魚 羊 丑
鱄	魚 {專上} 寸
鱅	魚 广 肀 月
鱆	魚 立 早
鱇	魚 广 彐 水
鱈	魚 雨 彐
鱉	丷 巾 八 魚
鱊	魚 予 丿 口
鱋	魚 {虎头} 业
鱌	魚 冖 口 豕
鱍	魚 癶 弓 殳
鱎	魚 夭 口 口
鱏	魚 西 早
鱐	魚 肀 片 一
鱑	魚 龷 由 八
鱒	魚 丷 酉 寸
鱓	魚 口 口 十
鱔	魚 羊 䒑 口
鱕	魚 丿 米 田
鱖	魚 厂 䒑 欠
鱗	魚 米 夕 ヰ
鱘	魚 彐 工 寸
鱙	魚 土 土 兀
鱚	魚 士 口 口
鱛	魚 丷 日 日
鱜	魚 {纟上} 丿 阝
鱝	魚 十 卄 貝
鱞	魚 罒 一 𧘇
鱟	臼 乂 乂 魚
鱠	魚 人 一 日
鱡	魚 貝 戈 {左上}
鱢	魚 口 口 木
鱣	魚 亠 囗 一
鱤	魚 戊 一 心
鱥	魚 止 戊 小
鱦	魚 黽
鱧	魚 冂 龷 䒑
鱨	魚 尚 匕 日
鱩	魚 雨 田
鱪	魚 日 耂 日
鱫	魚 爪 冖 夊
鱬	魚 雨 而
鱭	魚 亠 丷 二
鱮	魚 臼 丂 八
鱯	魚 艹 隹 又
鱰	魚 罒 耂 日
鱱	魚 厂 艹 禺
鱲	魚 巛 囗 {鼠下}
鱳	魚 白 幺 木
鱴	魚 艹 罒 丶
鱵	魚 竹 戊 口
鱶	魚 䒑 夫 艮
鱷	魚 王 口 口
鱸	魚 {虎头} 田 皿
鱹	魚 艹 口 隹
鱺	魚 一 {冂丶} 鹿
鱻	魚 魚 魚
鱽	鱼 刀
鱾	鱼 己
鲀	鱼 七 凵
鲃	鱼 巴
鲄	鱼 丁 口
鲉	鱼 由
鲊	鱼 𠂉 {乍下}
鲌	鱼 白
鲏	鱼 皮
鲓	鱼 耂 丂
鲖	鱼 冂 一 口
鲗	鱼 贝 刂
鲘	鱼 ⺁ 一 口
鲙	鱼 人 二 厶
鲝	羊 鱼
鲪	鱼 彐 丿 口
鲬	鱼 マ 用
鲯	鱼 其
鲹	鱼 厶 大 彡
鲾	鱼 一 口 田
鲿	鱼 龸 二 厶
鳀	鱼 日 一 龰
鳁	鱼 日 皿
鳂	鱼 田 {畏下}
鳈	鱼 白 水
鳉	鱼 丬 夕 寸
鳑	鱼 亠 丷 方
鳒	鱼 䒑 彐 八
鳚	鱼 尸 示 寸
鳛	鱼 习 习 白
鳠	鱼 艹 隹 又
鳡	鱼 戊 一 心
鳣	鱼 亠 囗 一
鳤	鱼 竹 宀 コ
鳥	鳥
鳦	鳥 乙
鳧	鳥 几
鳨	鳥 力
鳩	九 鳥
鳪	卜 鳥
鳫	厂 鳥
鳬	{鳥上} 几
鳭	刀 鳥
鳮	又 鳥
鳯	几 鳥
鳰	入 鳥
鳱	干 鳥
鳲	尸 鳥
鳳	几 一 鳥
鳴	口 鳥
鳵	乛 十 鳥
鳶	弋 鳥
鳷	十 又 鳥
鳸	户 鳥
鳹	人 丶 乛 鳥
鳺	夫 鳥
鳻	八 刀 鳥
鳼	文 鳥
鳽	一 卄 鳥
鳾	一 巾 鳥
鳿	王 鳥
鴀	不 鳥
鴁	夭 鳥
鴂	コ 人 鳥
鴃	鳥 コ 人
鴄	兀 乚 鳥
鴅	⺆ 亠 鳥
鴆	冖 儿 鳥
鴇	匕 十 鳥
鴈	厂 亻 鳥
鴉	牙 鳥
鴊	一 止 鳥
鴋	方 鳥
鴌	一 大 鳥
鴍	文 鳥
鴎	匚 乂 鳥
鴏	鳥 亻 弋
鴐	力 口 鳥
鴑	女 又 鳥
鴒	人 丶 マ 鳥
鴓	心 丿 鳥
鴔	丿 之 鳥
鴕	鳥 宀 匕
鴖	巳 七 鳥
鴗	立 鳥
鴘	厶 卄 鳥
鴙	矢 鳥
鴚	鳥 丁 口
鴛	夕 㔾 鳥
鴜	止 匕 鳥
鴝	勹 口 鳥
鴞	口 丂 鳥
鴟	{卬左} 七 丶 鳥
鴠	日 一 鳥
鴡	且 鳥
鴢	幺 力 鳥
鴣	古 鳥
鴤	鳥 夊 ⺀
鴥	鳥 穴
鴦	冂 大 鳥
鴧	宀 几 鳥
鴨	甲 鳥
鴩	丿 夫 鳥
鴪	穴 鳥
鴫	田 鳥
鴬	⺍ 冖 鳥
鴭	𠂤 鳥
鴮	大 一 丂 鳥
鴯	而 鳥
鴰	舌 鳥
鴱	艹 乂 鳥
鴲	匕 日 鳥
鴳	宀 女 鳥
鴴	彳 亍 鳥
鴵	儿 二 二 鳥
鴶	士 口 鳥
鴷	一 夕 刂 鳥
鴸	牛 八 鳥
鴹	羊 鳥
鴺	大 弓 鳥
鴻	氵 工 鳥
鴼	鳥 夊 口
鴽	女 口 鳥
鴾	厶 牛 鳥
鴿	合 鳥
鵀	亻 壬 鳥
鵁	亠 八 乂 鳥
鵂	亻 木 鳥
鵃	舟 鳥
鵄	至 鳥
鵅	夊 口 鳥
鵆	彳 鳥 亍
鵇	𠂉 ヰ 鳥
鵈	耳 鳥
鵉	亦 鳥
鵊	大 人 人 鳥
鵋	己 心 鳥
鵌	鳥 人 一 木
鵍	宀 一 兀 鳥
鵎	爪 女 鳥
鵏	甫 鳥
鵐	工 人 人 鳥
鵑	口 月 鳥
鵒	八 人 口 鳥
鵓	十 冖 子 鳥
鵔	鳥 厶 八 夊
鵕	厶 八 夊 鳥
鵖	彐 厶 鳥
鵗	乂 {左上} 巾 鳥
鵘	彐 丿 口 鳥
鵙	貝 鳥
鵚	禾 几 鳥
鵛	一 巛 工 鳥
鵜	丷 弓 丨 鳥
鵝	丿 扌 戈 鳥
鵞	丿 扌 戈 鳥
鵟	犭 王 鳥
鵠	⺧ 口 鳥
鵡	一 弋 止 鳥
鵢	身 鳥
鵣	木 口 鳥
鵤	冖 用 鳥
鵥	丷 キ 刂 鳥
鵦	鳥 彐 水
鵧	䒑 卄 鳥
鵨	人 干 口 鳥
鵩	月 卩 又 鳥
鵪	大 电 鳥
鵫	卜 早 鳥
鵬	月 月 鳥
鵭	金 鳥
鵮	冖 臼 鳥
鵯	{卑上} 十 鳥
鵰	⺆ 土 口 鳥
鵱	土 八 土 鳥
鵲	龷 日 鳥
鵳	户 月 鳥
鵴	勹 米 鳥
鵵	冖 口 儿 鳥
鵶	一 {亞下} 鳥
鵷	宀 夕 㔾 鳥
鵸	大 丁 口 鳥
鵹	禾 勹 丿 鳥
鵺	亠 亻 夕 鳥
鵻	鳥 隹
鵼	穴 工 鳥
鵽	又 又 又 鳥
鵾	日 匕 匕 鳥
鵿	鳥 日 丿 卄
鶀	鳥 其
鶁	{京頭} 小 鳥
鶂	臼 儿 鳥
鶃	鳥 臼 儿
鶄	龶 月 鳥
鶅	巛 田 鳥
鶆	來 鳥
鶇	木 日 鳥
鶈	十 彐 女 鳥
鶉	{京頭} 子 鳥
鶊	广 彐 人 鳥
鶋	尸 古 鳥
鶌	尸 屮 凵 鳥
鶍	日 勹 {两撇} 鳥
鶎	宀 示 鳥
鶏	爪 夫 鳥
鶐	木 丶 辶 鳥
鶑	火 火 鳥
鶒	木 口 力 鳥
鶓	艹 田 鳥
鶔	予 丿 木 鳥
鶕	立 日 鳥
鶖	禾 火 鳥
鶗	日 一 龰 鳥
鶘	古 月 鳥
鶙	亠 丷 冖 鳥
鶚	口 口 一 鳥
鶛	匕 匕 白 鳥
鶜	艹 予 丿 鳥
鶝	一 口 田 鳥
鶞	⺁ 十 目 鳥
鶟	穴 犬 鳥
鶠	匚 日 女 鳥
鶡	日 勹 人 鳥
鶢	爪 干 又 鳥
鶣	户 冊 鳥
鶤	冖 車 鳥
鶥	{眉上} 目 鳥
鶦	古 月 鳥
鶧	艹 冂 大 鳥
鶨	{互中} 豕 鳥
鶩	予 丿 夊 鳥
鶪	目 犬 鳥
鶫	木 囗 丷 鳥
鶬	人 丶 彐 鳥
鶭	糹 方 鳥
鶮	高 鳥
鶯	火 火 冖 鳥
鶰	口 貝 鳥
鶱	宀 {冓上} 八 鳥
鶲	八 厶 习 鳥
鶳	鳥 𠂤 一 巾
鶴	冖 隹 鳥
鶵	勹 屮 勹 鳥
鶶	广 肀 口 鳥
鶷	宀 丰 口 鳥
鶸	弓 二 弓 鳥
鶹	卯 田 鳥
鶺	二 二 人 鳥
鶻	骨 鳥
鶼	䒑 彐 〢 鳥
鶽	隹 十 鳥
鶾	十 早 𠂉 鳥
鶿	䒑 幺 幺 鳥
鷀	䒑 幺 幺 鳥
鷁	䒑 八 皿 鳥
鷂	爪 缶 鳥
鷃	日 宀 女 鳥
鷄	爪 幺 大 鳥
鷅	西 木 鳥
鷆	匕 目 乚 鳥
鷇	{穀頭} 一 鳥
鷈	鳥 ⺁ 虎
鷉	⺁ 虎 鳥
鷊	一 口 冂 鳥
鷋	艹 人 一 鳥
鷌	鳥 馬
鷍	自 木 鳥
鷎	白 大 十 鳥
鷏	十 且 八 鳥
鷐	日 辰 鳥
鷑	竹 立 鳥
鷒	{專上} 寸 鳥
鷓	广 卄 一 鳥
鷔	龶 勹 夊 鳥
鷕	口 隹 鳥
鷖	匚 矢 殳 鳥
鷗	匚 口 口 鳥
鷘	木 口 夊 鳥
鷙	土 䒑 十 鳥
鷚	习 习 人 鳥
鷛	广 肀 月 鳥
鷜	口 十 口 鳥
鷝	日 卄 キ 鳥
鷞	大 乂 乂 鳥
鷟	方 𠂉 矢 鳥
鷠	魚 鳥
鷡	𠂉 卌 一 鳥
鷢	厂 䒑 屮 鳥
鷣	西 早 鳥
鷤	口 口 日 鳥
鷥	糹 糸 鳥
鷦	隹 灬 鳥
鷧	士 冖 一 鳥
鷨	艹 干 龷 鳥
鷩	丷 巾 八 鳥
鷪	目 目 冖 鳥
鷫	肀 片 爿 鳥
鷬	龷 由 八 鳥
鷭	丿 米 田 鳥
鷮	夭 口 冂 鳥
鷯	大 丷 日 鳥
鷰	卄 一 口 鳥
鷱	自 二 二 鳥
鷲	{京頭} 小 尤 鳥
鷳	門 月 鳥
鷴	門 木 鳥
鷵	尸 耂 日 鳥
鷶	罒 貝 鳥
鷷	丷 酉 寸 鳥
鷸	予 丿 冂 鳥
鷹	广 亻 隹 鳥
鷺	足 夊 口 鳥
鷻	鳥 {京頭} 子 夊
鷼	門 日 鳥
鷽	臼 乂 乂 鳥
鷾	立 日 心 鳥
鷿	尸 口 辛 鳥
鸀	罒 勹 虫 鳥
鸁	{贏頭} 鳥
鸂	氵 爪 幺 鳥
鸃	鳥 羊 丿 戈
鸄	白 方 夊 鳥
鸅	罒 土 䒑 鳥
鸆	{虎头} 口 一 鳥
鸇	亠 囗 口 鳥
鸈	业 羊 八 鳥
鸉	木 日 一 鳥
鸊	尸 口 辛 鳥
鸋	宀 心 皿 鳥
鸌	鳥 艹 隹 又
鸍	一 八 巾 鳥
鸎	貝 貝 鳥
鸏	艹 冖 一 鳥
鸐	习 习 隹 鳥
鸑	犭 言 犬 鳥
鸒	臼 丂 丄 鳥
鸓	田 田 田 鳥
鸔	鳥 日 龷 水
鸕	{虎头} 田 皿 鳥
鸖	雨 隹 鳥
鸗	立 月 {龍右} 鳥
鸘	雨 木 目 鳥
鸙	合 口 口 鳥
鸚	貝 貝 女 鳥
鸛	艹 口 口 鳥
鸜	目 目 隹 鳥
鸝	一 {冂丶} 一 鳥
鸞	言 糹 糹 鳥
鸤	尸 鸟
鸧	人 㔾 鸟
鸮	口 丂 鸟
鸰	人 丶 マ 鸟
鸴	⺍ 冖 鸟
鸻	彳 亍 鸟
鸼	舟 鸟
鹀	工 人 人 鸟
鹍	日 匕 匕 鸟
鹐	冖 臼 鸟
鹒	广 彐 人 鸟
鹓	宀 夕 㔾 鸟
鹔	肀 {介下} 八 鸟
鹖	日 勹 人 鸟
鹙	禾 火 鸟
鹝	一 口 冂 鸟
鹟	八 厶 习 鸟
鹠	卯 田 鸟
鹡	二 二 人 鸟
鹢	䒑 八 皿 鸟
鹥	匚 矢 殳 鸟
鹮	罒 一 口 鸟
鹯	亠 囗 口 鸟
鹲	艹 冖 一 鸟
鹴	雨 木 目 鸟
鹵	鹵
鹶	鹵 人 丶 乛
鹷	鹵 人 丶 マ
鹸	鹵 合 人
鹹	鹵 戊 一 口
鹺	鹵 羊 工
鹻	鹵 䒑 彐 八
鹼	鹵 僉
鹽	臣 𠂉 鹵 皿
麀	鹿 匕
麁	冖 鹿
麃	鹿 灬
麄	八 刀 鹿
麅	鹿 勹 巳
麆	鹿 且
麉	干 干 鹿
麊	米 鹿
麌	鹿 口 一 大
麍	鹿 亠 厶 {荒下}
麎	鹿 辰
麏	鹿 彐 丿 口
麐	鹿 文 口
麑	鹿 臼 儿
麔	鹿 夊 卜 口
麕	鹿 囗 禾
麖	鹿 {京頭} 小
麗	一 {冂丶} 一 鹿
麘	鹿 禾 日
麙	鹿 戊 一 口
麚	鹿 尸 二 又
麛	鹿 弓 耳
麜	鹿 西 木
麞	鹿 立 早
麠	鹿 一 田 一
麡	鹿 亠 丷 二
麢	鹿 雨 口 口
麣	鹿 口 口 夊
麤	鹿 鹿 鹿
麥	來 夊
麧	來 夊 𠂉 乙
麨	來 夊 小 丿
麩	來 夊 夫
麪	來 夊 丅 乛
麫	來 夊 丅 ㇉
麬	來 夊 皮
麭	來 夊 勹 巳
麮	來 夊 土 厶
麯	來 夊 冂 龷
麰	來 夊 厶 牛
麱	來 夊 甫
麲	來 夊 見
麳	來 夊 來
麵	來 夊 面
麶	來 夊 文 厶
麷	來 夊 山 䒑
麹	龶 夊 勹 米
麺	龶 夊 面
麼	麻 幺
麿	麻 口 口
黀	麻 耳 又
黁	麻 禾 日
黂	麻 十 卄 貝
黃	艹 二 由 八
黅	龷 由 八 乛
黆	龷 由 八 儿
黇	龷 由 八 口
黈	龷 由 八 王
黊	龷 由 八 土
黋	小 兀 龷 八
黌	臼 乂 乂 八
黐	禾 人 水 厶
黒	里 灬
黓	黑 弋
黕	黑 冖 儿
黖	黑 匚 儿
黗	黑 七 凵
黙	里 犬 灬
黚	黑 卄 二
點	黑 卜 口
黡	厂 犬 黑
黣	黑 𠂉 母
黤	黑 大 电
黦	黑 宀 夕 㔾
黨	尚 黑
黫	黑 西 土
黬	黑 戊 一 口
黭	黑 合 卄
黮	黑 其 乚
黰	黑 十 且 八
黱	月 丷 夫 黑
黲	黑 厶 厶 彡
黳	匚 矢 殳 黑
黴	{微上} 一 黑
黵	黑 冖 厂 言
黶	厂 日 月 黑
黷	黑 士 罒 貝
黸	黑 {虎头} 田 皿
黺	业 丷 巾 刀
黽	黽
黿	一 兀 黽
鼀	土 八 黽
鼁	土 厶 黽
鼂	日 一 黽
鼃	土 土 黽
鼄	牛 八 黽
鼅	矢 口 黽
鼆	冖 日 亠 黽
鼇	龶 勹 夊 黽
鼈	丷 巾 八 黽
鼉	口 口 田 黽
鼊	尸 口 辛 黽
鼌	日 一 口 电
鼏	冖 目 爿 片
鼑	卜 目 爿 片
鼒	{于下} 丿 目 片
鼔	士 口 䒑 又
鼕	士 口 䒑 ⺀
鼖	十 卄 士 又
鼘	士 口 䒑 一
鼚	士 口 䒑 長
鼛	士 口 䒑 口
鼜	士 口 䒑 虫
鼝	氵 片 爿 又
鼞	士 口 䒑 土
鼟	士 口 䒑 䒑
鼡	⺍ 几 キ
鼣	臼 {鼠下} 犬
鼤	臼 {鼠下} 文
鼥	臼 {鼠下} {左上} 丶
鼦	臼 {鼠下} 刀 口
鼧	臼 {鼠下} 宀 匕
鼨	臼 {鼠下} 夊 ⺀
鼩	臼 {鼠下} 勹 口
鼪	臼 {鼠下} 生
鼫	臼 {鼠下} 石
鼭	臼 {鼠下} 土 寸
鼮	臼 {鼠下} 壬 廴
鼰	臼 {鼠下} 貝
鼱	臼 {鼠下} 龶 月
鼲	臼 {鼠下} 冖 車
鼳	臼 {鼠下} 目 犬
鼴	臼 {鼠下} 匚 女
鼵	臼 {鼠下} 穴 犬
鼶	臼 {鼠下} ⺁ 虎
鼸	臼 {鼠下} 䒑 八
鼺	臼 {鼠下} 田 田
鼼	自 田 丌 丩
鼿	自 田 丌 兀
齀	自 田 丌 瓦
齁	自 田 丌 口
齂	自 田 丌 水
齃	自 田 丌 乚
齅	自 田 丌 犬
齆	自 田 丌 巴
齇	自 田 丌 且
齈	自 田 丌 辰
齉	自 田 丌 𧘇
齊	亠 丷 丨 二
齋	亠 丷 丨 示
齌	亠 丷 丨 火
齍	亠 丷 丨 皿
齎	亠 丷 丨 貝
齏	亠 丷 丨 一
齒	齒
齓	齒 乚
齔	齒 匕
齕	齒 𠂉 乙
齖	齒 牙
齗	齒 斤
齘	齒 人 {介下}
齙	齒 勹 巳
齚	齒 𠂉 {乍下}
齛	齒 世
齜	齒 止 匕
齝	齒 厶 口
齞	齒 口 八
齟	齒 且
齠	齒 刀 口
齡	齒 人 丶 マ
齢	止 米 凵 マ
齣	齒 勹 口
齤	丷 夫 齒
齥	齒 电 丿
齦	齒 艮
齧	丰 刀 齒
齨	齒 臼
齩	齒 亠 八 乂
齪	齒 足
齫	齒 囗 木
齬	齒 一 {五下} 口
齭	齒 戶 斤
齮	齒 大 丁 口
齯	齒 臼 儿
齰	齒 龷 日
齱	齒 耳 又
齲	齒 丿 虫 冂
齳	齒 冖 車
齴	齒 立 丿 彡
齵	齒 禺
齶	齒 口 口 丂
齷	齒 尸 至
齸	齒 䒑 八 皿
齹	羊 工 齒
齺	齒 勹 屮 屮
齻	齒 十 且 八
齼	齒 木 木 龰
齽	齒 木 木 示
齾	{虎头} 一 口 齒
龁	止 人 凵 乙
龂	止 人 凵 斤
龍	立 月 {龍右}
龎	厂 立 月 {龍右}
龏	立 月 {龍右} 卄
龐	广 立 月 {龍右}
龑	立 月 {龍右} 大
龒	立 月 {龍右} 示
龓	{左上} 月 立 {龍右}
龔	立 月 {龍右} 八
龕	合 立 月 {龍右}
龖	立 月 {龍右} {龍右}
龗	雨 口 口 {龍右}
龘	立 月 {龍右} {龍右}
龜	丿 {龜下}
龝	禾 丿 {龜下}
龞	丷 巾 八 {龜下}
龡	合 口 口 欠
龢	合 口 口 禾
龣	合 口 口 水
龤	合 口 口 白
龥	合 口 口 貝
龴	マ
龵	龵
龶	龶
龷	龷
龸	龸
㑇	亻 冖 彐
㑳	亻 勹 屮 屮
㓁	冖 八
㔾	㔾
㖞	口 口 冂 人
㘎	口 门 乛 夊
㘚	口 門 乛 夊
㣺	忄 丶
㤘	忄 冖 彐
㥮	忄 勹 屮 屮
㧏	扌 冂 乂
㧐	扌 又 又
㧟	扌 氵 匚
㩳	扌 隹 隹 又
㭎	木 冂 乂
㱮	一 夕 口 贝
㳠	氵 大 辶
䁖	目 米 女
䅟	禾 厶 大 彡
䌷	纟 由
䎬	丰 八 罒 厶
䎱	丰 八 罒 匕
䏝	月 二 ㇉ 丶
䓖	艹 穴 力
䙌	衤 口 丄 贝
䙡	衤 口 丄 貝
䜌	言 糹 糹
䜣	讠 斤
䜩	讠 卄 一 灬
䝼	貝 龶 月
䞍	贝 龶 月
䥇	金 户 习 习
䥺	钅 牙
䥽	钅 丩 又 丶
䦂	钅 户 习 习
䦃	钅 艹 耂 日
䦅	钅 羊 䒑 口
䦆	钅 目 目 又
䦛	門 冖 彐 亅
䦟	門 人 人 土
䦶	门 冖 彐 亅
䦷	门 人 人 土
䱷	{虎头} 魚 夊
䲟	鱼 {卬左} 一 卩
䲠	鱼 𡗗 日
䲡	鱼 丷 酉
䲢	月 丷 夫 鱼
䲣	{虎头} 鱼 夊
䴓	一 巾 鸟
䴔	亠 八 乂 鸟
䴕	一 夕 刂 鸟
䴖	龶 月 鸟
䴗	目 犬 鸟
䴘	⺁ 虎 鸟
䴙	尸 口 辛 鸟
䶮	尤 丿 一 大
𠂆	⺁
𠂇	{左上}
𠂉	𠂉
𠂊	冖
𠂒	⺧
𠃌	乛
𠔉	八 夫
𠦝	十 早
𡗗	𡗗
𡭔	小
𢦏	十 戈
𤇾	火 火 冖
𤴔	乛 止
𥫗	竹
𦍌	羊
𧾷	足
⺄	乛
⺶	羊
⺻	肀 一
郎	丶 艮 阝
凉	二 亠 口 小
秊	禾 千
裏	亠 里 𧘇
隣	阝 米 夕 ヰ
兀	兀
嗀	{穀頭} 一 口
﨎	文 隹 又
﨏	土 八 人 口
﨑	山 立 口 亅
﨓	木 艹 亻 寸
﨔	木 {兴上} 八 手
礼	示 乚
﨟	艹 月 日 乚
蘒	艹 禾 丿 {龜下}
﨡	虫 生
﨣	走 ⺀ 十
﨤	乃 乀 辶
﨧	金 耂 子
﨨	金 土 䒑 十
﨩	阝 {鳥上} 山
龦	火 尚 巾
龧	日 日 耂 日
龨	匚 隹
龩	艹 革 斤
龪	走 人
龫	車 人 干
龬	金 冂 䒑 亡
龭	馬 田 龷 八
龮	馬 习 习 八
龯	金 戊
龰	龰
龱	囗 乂
龲	金 广 車
龳	土 儿 土 土
龹	丷 夫
龺	十 早
龻	言 糹 糹
龼	土 卜 冖 目
龽	火 魚
龾	皮 勹 米
龿	艹 亻 土 土
鿀	艹 匚 矢 酉
鿁	言 龷 八
鿂	車 鳥
鿃	目 大 入 入
鿄	氵 刀 丶 木
鿅	示 雨 人 卩
鿆	示 {左上} 又
鿇	亻 冖 彐 亅
鿈	彳 尸 乀
鿉	彳 一 {五下}
鿊	艹 氵 止
鿋	衤 士 口 口
鿌	氵 亠 日 小
鿍	土 夊 ヰ
鿎	石 大 辶
鿏	钅 龶 夊
鿐	魚 氵 酉
鿑	二 王 丶
鿒	艹 丆 贝
鿓	艹 丆 貝
鿔	钅 丁 口 口
鿕	鱼 ⺆ 亠
鿖	合 一
鿗	人 亻 彐 一
鿘	亻 彐 丿 合
鿙	亻 彐 丿 儿
鿚	亻 彐 丿 口
鿛	二 土 八 乂
鿜	扌 立 一 乂
鿝	木 罒 方 乂
鿞	一 夕 刂 乂
鿟	禾 刂 冖 小
鿠	禾 刂 一 乂
鿡	罒 糹 隹 乂
鿢	耳 阝 合
鿣	耳 阝 古 儿
鿤	耳 阝 木 口
鿥	丶 彐 厶 乂
鿦	艹 冂 大 几
鿧	阝 夊 一 乂
鿨	雨 田 一 乂
鿩	魚 日 一 乂
鿪	八 豕 辶 灬
鿫	气 {向框} 米 大
鿬	石 田
鿭	钅 冖 小
鿮	广 卅 一 巾
鿯	牛 勹 {两撇} 米
鿰	氵 十 早 乛
鿱	王 巴
鿲	一 口 䒑 力
鿳	魚 舟 宀 匕
鿴	鱼 夊 ⺀
鿵	鱼 士 心
鿶	鱼 丶 艮
鿷	鱼 立 日
鿸	鱼 舟 宀 匕
鿹	鱼 宀 心 山
鿺	龶 夊 鸟
鿻	臼 {鼠下} {左上} 巾
鿼	臼 {鼠下} 力 口
鿽	口 穴 𠂉 {乍下}
鿾	土 丶 彐 阝
鿿	甫 人 水
⺀	⺀
⺁	⺁
⺂	乛
⺃	乚
⺅	亻
⺆	⺆
⺇	几
⺈	冖
⺉	刂
⺊	卜
⺋	㔾
⺌	小
⺍	⺍
⺎	兀
⺏	八 儿
⺐	尢
⺑	八 几
⺒	巳
⺓	幺
⺔	{互中} 一
⺕	彐
⺖	忄
⺗	小 丶
⺘	扌
⺙	夊
⺛	匚 儿
⺜	冂 二
⺝	月
⺞	卜 夕
⺟	母
⺠	巳 七
⺡	氵
⺢	水
⺣	灬
⺤	爪
⺥	爪
⺦	丬
⺧	⺧
⺨	犭
⺩	王
⺪	乛 止
⺫	罒
⺬	示
⺭	示
⺮	竹
⺯	糹
⺰	纟
⺱	冂 乂
⺲	罒
⺳	冖 八
⺴	冖 儿
⺵	冂 〢
⺷	羊
⺸	艹 干
⺹	耂
⺺	肀
⺼	月
⺽	臼
⺾	艹
⺿	艹
⻀	卝
⻁	虎
⻂	衤
⻃	西
⻄	西
⻅	见
⻆	冖 用
⻇	冖 ⺆ 人 人
⻈	讠
⻉	贝
⻊	足
⻋	车
⻌	辶
⻍	辶
⻎	辶
⻏	阝
⻐	钅
⻑	長
⻒	镸
⻓	长
⻔	门
⻕	𠂤 コ
⻖	阝
⻗	雨
⻘	龶 月
⻙	キ 乛
⻚	丆 贝
⻛	几 乂
⻜	乛 二
⻝	食
⻞	食
⻟	食
⻠	饣
⻡	巛 丆 目
⻢	马
⻣	骨
⻤	鬼
⻥	鱼
⻦	鸟
⻧	卜 囗 乂
⻨	龶 夊
⻩	龷 由 八
⻪	口 电
⻫	文 {介下} 二
⻬	文 {介下}
⻭	止 米 凵
⻮	止 人 凵
⻯	立 电
⻰	尤 丿
⻱	丿 {龜下}
⻲	冖 日 电
⻳	冖 电
⼀	一
⼁	丨
⼂	丶
⼃	丿
⼄	乙
⼅	亅
⼆	二
⼇	亠
⼈	人
⼉	儿
⼊	入
⼋	八
⼌	冂
⼍	冖
⼎	二
⼏	几
⼐	凵
⼑	刀
⼒	力
⼓	勹
⼔	匕
⼕	匚
⼖	匚
⼗	十
⼘	卜
⼙	卩
⼚	厂
⼛	厶
⼜	又
⼝	口
⼞	囗
⼟	土
⼠	士
⼡	夊
⼢	夊
⼣	夕
⼤	大
⼥	女
⼦	子
⼧	宀
⼨	寸
⼩	小
⼪	尢
⼫	尸
⼬	屮
⼭	山
⼮	巛
⼯	工
⼰	己
⼱	巾
⼲	干
⼳	幺
⼴	广
⼵	廴
⼶	卄
⼷	弋
⼸	弓
⼹	彐
⼺	彡
⼻	彳
⼼	心
⼽	戈
⼾	戶
⼿	手
⽀	十 又
⽁	卜 又
⽂	文
⽃	⺀ 十
⽄	斤
⽅	方
⽆	一 尢
⽇	日
⽈	日
⽉	月
⽊	木
⽋	欠
⽌	止
⽍	一 夕
⽎	殳
⽏	{母框} 十
⽐	匕 匕
⽑	毛
⽒	{卬左} 七
⽓	气
⽔	水
⽕	火
⽖	爪
⽗	八 乂
⽘	乂 乂
⽙	爿
⽚	片
⽛	牙
⽜	牛
⽝	犬
⽞	亠 幺
⽟	王 丶
⽠	瓜
⽡	瓦
⽢	卄 二
⽣	生
⽤	用
⽥	田
⽦	乛 龰
⽧	疒
⽨	癶
⽩	白
⽪	皮
⽫	皿
⽬	目
⽭	予 丿
⽮	矢
⽯	石
⽰	示
⽱	冂 厶
⽲	禾
⽳	穴
⽴	立
⽵	竹
⽶	米
⽷	糸
⽸	缶
⽹	冂 乂 乂
⽺	羊
⽻	习 习
⽼	耂 匕
⽽	而
⽾	丰 八
⽿	耳
⾀	彐 キ
⾁	冂 人 人
⾂	臣
⾃	自
⾄	至
⾅	臼
⾆	舌
⾇	夕 ヰ
⾈	舟
⾉	艮
⾊	冖 巴
⾋	屮 屮
⾌	{虎头}
⾍	虫
⾎	丿 皿
⾏	彳 亍
⾐	亠 𧘇
⾑	一 冂 凵
⾒	見
⾓	冖 用
⾔	言
⾕	八 人 口
⾖	一 口 䒑
⾗	豕
⾘	豸
⾙	貝
⾚	土 {介下} 八
⾛	走
⾜	足
⾝	身
⾞	車
⾟	辛
⾠	辰
⾡	彡 龰
⾢	口 巴
⾣	酉
⾤	丿 米
⾥	里
⾦	金
⾧	長
⾨	門
⾩	𠂤 十
⾪	彐 水
⾫	隹
⾬	雨
⾭	龶 冂 丄
⾮	非
⾯	面
⾰	革
⾱	韋
⾲	非 一
⾳	立 日
⾴	丆 貝
⾵	風
⾶	飛
⾷	食
⾸	䒑 自
⾹	禾 日
⾺	馬
⾻	骨
⾼	高
⾽	髟
⾾	鬥
⾿	𠂭 凵 匕
⿀	一 口 冂 丨
⿁	鬼
⿂	魚
⿃	鳥
⿄	鹵
⿅	鹿
⿆	來 夊
⿇	麻
⿈	艹 二 由 八
⿉	禾 人 水
⿊	黑
⿋	业 丷 巾 八
⿌	黽
⿍	目 爿 片
⿎	士 口 䒑 又
⿏	臼 {鼠下}
⿐	自 田 丌
⿑	亠 丷 丨 二
⿒	齒
⿓	立 月 {龍右}
⿔	冖 {龜下}
⿕	合 口 口 冊
㇀	一
㇁	丿
㇂	乚
㇃	丶
㇄	乚
㇅	乛
㇆	乛
㇇	乛
㇈	乛
㇉	㇉
㇊	乁
㇋	𠄎
㇌	𠄎
㇍	乛
㇎	𠄎
㇏	乀
㇐	一
㇑	丨
㇒	丿
㇓	丿
㇔	丶
㇕	乛
㇖	乛
㇗	乚
㇘	亅
㇙	乚
㇚	亅
㇛	𡿨
㇜	乚
㇝	乀
㇞	乚
㇟	乚
㇠	乙
㇡	𠄎
㇢	亅
㇣	〇
々	冖 丶
〇	〇
〢	〢
〣	〣
キ	キ
コ	コ
ス	ス
ッ	⺍
マ	マ
ュ	コ
ユ	コ
リ	リ
ヰ	ヰ
